//MAP CONVERTED BY dmm2tgm.py THIS HEADER COMMENT PREVENTS RECONVERSION, DO NOT REMOVE
"a" = (
/turf/closed/wall/indestructible/reinforced,
/area/centcom/mafia)
"c" = (
/turf/closed/wall/rust,
/area/centcom/mafia)
"d" = (
/turf/open/floor/plating,
/area/centcom/mafia)
"f" = (
/obj/effect/mapping_helpers/burnt_floor,
/turf/open/floor/plating,
/area/centcom/mafia)
"g" = (
/obj/mafia_game_board,
/obj/effect/mapping_helpers/broken_floor,
/turf/open/floor/plating,
/area/centcom/mafia)
"h" = (
/obj/structure/grille/indestructible,
/turf/open/floor/plating,
/area/centcom/mafia)
"i" = (
/obj/effect/mapping_helpers/broken_floor,
/turf/open/floor/plating,
/area/centcom/mafia)
"j" = (
/obj/machinery/door/airlock/external/ruin{
	max_integrity = 99999;
	name = "Maintenance"
	},
/obj/effect/mapping_helpers/airlock/locked,
/turf/open/floor/plating,
/area/centcom/mafia)
"k" = (
/obj/mafia_game_board,
/turf/open/floor/plating,
/area/centcom/mafia)
"l" = (
/obj/structure/closet{
	desc = "It's a storage unit. For mining stuff. Y'know.";
	icon_state = "mining";
	name = "miner equipment locker"
	},
/obj/item/clothing/under/rank/cargo/miner/lavaland,
/turf/open/floor/fakebasalt,
/area/centcom/mafia)
"m" = (
/obj/effect/landmark/mafia,
/turf/open/floor/fakebasalt,
/area/centcom/mafia)
"n" = (
/obj/effect/landmark/mafia,
/obj/effect/turf_decal/trimline/brown/filled/line{
	dir = 9
	},
/obj/effect/turf_decal/trimline/brown/filled/corner,
/turf/open/floor/iron,
/area/centcom/mafia)
"o" = (
/obj/effect/turf_decal/trimline/brown/filled/end{
	dir = 4
	},
/obj/structure/closet{
	desc = "It's a storage unit. For mining stuff. Y'know.";
	icon_state = "mining";
	name = "miner equipment locker"
	},
/obj/item/clothing/under/rank/cargo/miner/lavaland,
/turf/open/floor/iron,
/area/centcom/mafia)
"p" = (
/obj/machinery/door/poddoor/preopen{
	desc = "When it's time to sleep, the lights will go out. Remember - no one in space can hear you scream.";
	id = "mafia";
	max_integrity = 99999;
	name = "Station Night Shutters"
	},
/turf/closed/indestructible/fakeglass,
/area/centcom/mafia)
"q" = (
/turf/open/floor/fakebasalt,
/area/centcom/mafia)
"r" = (
/obj/effect/turf_decal/trimline/brown/filled/line{
	dir = 9
	},
/obj/structure/closet{
	desc = "It's a storage unit. For mining stuff. Y'know.";
	icon_state = "mining";
	name = "miner equipment locker"
	},
/obj/item/clothing/under/rank/cargo/miner/lavaland,
/turf/open/floor/iron,
/area/centcom/mafia)
"s" = (
/obj/effect/turf_decal/trimline/brown/filled/line{
	dir = 9
	},
/turf/open/floor/iron,
/area/centcom/mafia)
"t" = (
/obj/effect/turf_decal/tile/red,
/obj/effect/turf_decal/tile/red{
	dir = 8
	},
/turf/open/floor/iron/dark,
/area/centcom/mafia)
"u" = (
/obj/effect/turf_decal/tile/red{
	dir = 4
	},
/obj/effect/turf_decal/tile/red,
/turf/open/floor/iron/dark,
/area/centcom/mafia)
"v" = (
/obj/mafia_game_board,
/obj/effect/mapping_helpers/burnt_floor,
/turf/open/floor/plating,
/area/centcom/mafia)
"w" = (
/obj/effect/turf_decal/trimline/brown/filled/line{
	dir = 1
	},
/obj/effect/turf_decal/trimline/brown/filled/corner,
/turf/open/floor/iron,
/area/centcom/mafia)
"x" = (
/obj/effect/turf_decal/trimline/brown/filled/line{
	dir = 1
	},
/obj/effect/turf_decal/trimline/brown/filled/line,
/turf/open/floor/iron,
/area/centcom/mafia)
"y" = (
/obj/effect/turf_decal/trimline/brown/filled/end{
	dir = 4
	},
/turf/open/floor/iron,
/area/centcom/mafia)
"z" = (
/obj/effect/turf_decal/trimline/brown/filled/line{
	dir = 5
	},
/obj/structure/closet{
	desc = "It's a storage unit. For mining stuff. Y'know.";
	icon_state = "mining";
	name = "miner equipment locker"
	},
/obj/item/clothing/under/rank/cargo/miner/lavaland,
/turf/open/floor/iron,
/area/centcom/mafia)
"A" = (
/obj/effect/landmark/mafia,
/obj/effect/turf_decal/trimline/brown/filled/line{
	dir = 6
	},
/turf/open/floor/iron,
/area/centcom/mafia)
"B" = (
/obj/effect/turf_decal/trimline/brown/filled/end{
	dir = 1
	},
/turf/open/floor/iron,
/area/centcom/mafia)
"C" = (
/obj/effect/turf_decal/trimline/brown/filled/line{
	dir = 4
	},
/obj/effect/turf_decal/trimline/brown/filled/line{
	dir = 8
	},
/turf/open/floor/iron,
/area/centcom/mafia)
"D" = (
/obj/effect/turf_decal/trimline/brown/filled/line{
	dir = 10
	},
/obj/effect/turf_decal/trimline/brown/filled/corner{
	dir = 4
	},
/turf/open/floor/iron,
/area/centcom/mafia)
"E" = (
/obj/effect/turf_decal/trimline/brown/filled/line{
	dir = 1
	},
/obj/effect/turf_decal/trimline/brown/filled/corner{
	dir = 8
	},
/turf/open/floor/iron,
/area/centcom/mafia)
"F" = (
/obj/effect/turf_decal/trimline/brown/filled/line{
	dir = 5
	},
/turf/open/floor/iron,
/area/centcom/mafia)
"G" = (
/obj/effect/landmark/mafia,
/obj/effect/turf_decal/trimline/brown/filled/line{
	dir = 10
	},
/turf/open/floor/iron,
/area/centcom/mafia)
"H" = (
/obj/effect/turf_decal/trimline/brown/filled/line{
	dir = 10
	},
/obj/structure/closet{
	desc = "It's a storage unit. For mining stuff. Y'know.";
	icon_state = "mining";
	name = "miner equipment locker"
	},
/obj/item/clothing/under/rank/cargo/miner/lavaland,
/turf/open/floor/iron,
/area/centcom/mafia)
"I" = (
/obj/effect/turf_decal/trimline/brown/filled/line{
	dir = 6
	},
/obj/structure/closet{
	desc = "It's a storage unit. For mining stuff. Y'know.";
	icon_state = "mining";
	name = "miner equipment locker"
	},
/obj/item/clothing/under/rank/cargo/miner/lavaland,
/turf/open/floor/iron,
/area/centcom/mafia)
"J" = (
/obj/effect/landmark/mafia,
/obj/effect/turf_decal/trimline/brown/filled/line{
	dir = 6
	},
/obj/effect/turf_decal/trimline/brown/filled/corner{
	dir = 1
	},
/turf/open/floor/iron,
/area/centcom/mafia)
"K" = (
/obj/effect/turf_decal/trimline/brown/filled/end{
	dir = 8
	},
/obj/structure/closet{
	desc = "It's a storage unit. For mining stuff. Y'know.";
	icon_state = "mining";
	name = "miner equipment locker"
	},
/obj/item/clothing/under/rank/cargo/miner/lavaland,
/turf/open/floor/iron,
/area/centcom/mafia)
"L" = (
/obj/effect/landmark/mafia,
/obj/effect/turf_decal/trimline/brown/filled/line{
	dir = 5
	},
/turf/open/floor/iron,
/area/centcom/mafia)
"M" = (
/obj/effect/turf_decal/trimline/brown/filled/line{
	dir = 10
	},
/turf/open/floor/iron,
/area/centcom/mafia)
"N" = (
/obj/effect/turf_decal/trimline/brown/filled/line,
/obj/effect/turf_decal/trimline/brown/filled/corner{
	dir = 4
	},
/turf/open/floor/iron,
/area/centcom/mafia)
"O" = (
/obj/effect/turf_decal/trimline/brown/filled/corner{
	dir = 8
	},
/obj/effect/turf_decal/trimline/brown/filled/line{
	dir = 5
	},
/turf/open/floor/iron,
/area/centcom/mafia)
"P" = (
/obj/effect/turf_decal/trimline/brown/filled/end,
/turf/open/floor/iron,
/area/centcom/mafia)
"Q" = (
/obj/effect/landmark/mafia,
/obj/effect/turf_decal/trimline/brown/filled/line{
	dir = 9
	},
/turf/open/floor/iron,
/area/centcom/mafia)
"R" = (
/obj/effect/baseturf_helper/asteroid,
/obj/effect/landmark/mafia/town_center,
/obj/effect/turf_decal/tile/red/fourcorners,
/turf/open/floor/iron/dark,
/area/centcom/mafia)
"S" = (
/obj/effect/turf_decal/trimline/brown/filled/end{
	dir = 8
	},
/turf/open/floor/iron,
/area/centcom/mafia)
"T" = (
/obj/effect/turf_decal/trimline/brown/filled/line,
/obj/effect/turf_decal/trimline/brown/filled/line{
	dir = 1
	},
/turf/open/floor/iron,
/area/centcom/mafia)
"U" = (
/obj/effect/turf_decal/trimline/brown/filled/line,
/obj/effect/turf_decal/trimline/brown/filled/corner{
	dir = 1
	},
/turf/open/floor/iron,
/area/centcom/mafia)
"V" = (
/obj/effect/turf_decal/trimline/brown/filled/line{
	dir = 6
	},
/turf/open/floor/iron,
/area/centcom/mafia)
"W" = (
/obj/effect/turf_decal/tile/red{
	dir = 8
	},
/obj/effect/turf_decal/tile/red{
	dir = 1
	},
/turf/open/floor/iron/dark,
/area/centcom/mafia)
"X" = (
/obj/effect/turf_decal/tile/red{
	dir = 1
	},
/obj/effect/turf_decal/tile/red{
	dir = 4
	},
/turf/open/floor/iron/dark,
/area/centcom/mafia)

(1,1,1) = {"
a
a
a
a
a
a
a
a
a
a
a
a
a
a
a
a
a
a
a
a
a
a
a
"}
(2,1,1) = {"
a
a
a
a
a
a
a
a
a
a
a
a
a
a
a
a
a
a
a
a
a
a
a
"}
(3,1,1) = {"
a
a
a
c
c
c
c
c
c
c
c
c
c
c
c
c
c
c
c
c
a
a
a
"}
(4,1,1) = {"
a
a
a
c
g
h
d
d
d
d
d
i
d
d
d
d
d
h
k
c
a
a
a
"}
(5,1,1) = {"
a
a
a
c
h
d
d
i
a
a
j
a
j
a
a
d
d
i
h
c
a
a
a
"}
(6,1,1) = {"
a
a
a
c
i
a
a
j
a
l
q
a
s
H
a
j
a
a
d
c
a
a
a
"}
(7,1,1) = {"
a
a
c
c
d
a
r
M
p
m
q
p
w
A
p
q
l
a
d
c
c
a
a
"}
(8,1,1) = {"
a
a
c
d
d
a
L
N
a
a
q
a
x
a
a
q
m
a
d
d
c
a
a
"}
(9,1,1) = {"
a
a
c
d
a
a
p
O
P
p
q
p
y
p
q
q
p
a
a
d
c
a
a
"}
(10,1,1) = {"
a
a
c
d
a
l
p
a
p
p
p
p
p
p
p
a
p
K
a
d
c
a
a
"}
(11,1,1) = {"
a
a
c
d
j
m
q
q
q
p
q
u
q
p
B
C
C
J
j
i
c
a
a
"}
(12,1,1) = {"
a
a
c
i
a
a
p
a
p
p
t
R
X
p
p
a
p
a
a
d
c
a
a
"}
(13,1,1) = {"
a
a
c
d
j
n
C
C
P
p
q
W
q
p
q
q
q
m
j
d
c
a
a
"}
(14,1,1) = {"
a
a
c
d
a
o
p
a
p
p
p
p
p
p
p
a
p
l
a
i
c
a
a
"}
(15,1,1) = {"
a
a
c
d
a
a
p
q
q
p
S
p
q
p
B
D
p
a
a
d
c
a
a
"}
(16,1,1) = {"
a
a
c
f
d
a
m
q
a
a
T
a
q
a
a
E
G
a
d
d
c
a
a
"}
(17,1,1) = {"
a
a
c
c
d
a
l
q
p
Q
U
p
q
m
p
F
I
a
d
c
c
a
a
"}
(18,1,1) = {"
a
a
a
c
d
a
a
j
a
z
V
a
q
l
a
j
a
a
d
c
a
a
a
"}
(19,1,1) = {"
a
a
a
c
h
i
d
d
a
a
j
a
j
a
a
d
i
d
h
c
a
a
a
"}
(20,1,1) = {"
a
a
a
c
k
h
d
d
i
d
d
d
d
d
d
d
d
h
v
c
a
a
a
"}
(21,1,1) = {"
a
a
a
c
c
c
c
c
c
c
c
c
c
c
c
c
c
c
c
c
a
a
a
"}
(22,1,1) = {"
a
a
a
a
a
a
a
a
a
a
a
a
a
a
a
a
a
a
a
a
a
a
a
"}
(23,1,1) = {"
a
a
a
a
a
a
a
a
a
a
a
a
a
a
a
a
a
a
a
a
a
a
a
"}
