//MAP CONVERTED BY dmm2tgm.py THIS HEADER COMMENT PREVENTS RECONVERSION, DO NOT REMOVE
"ag" = (
/obj/structure/cable,
/obj/machinery/power/port_gen/pacman,
/turf/open/floor/plating,
/area/planet/ruin/engi_outpost)
"ah" = (
/obj/machinery/space_heater,
/turf/open/floor/plating,
/area/planet/ruin/engi_outpost)
"am" = (
/obj/effect/turf_decal/stripes/line{
	dir = 1
	},
/mob/living/simple_animal/hostile/giant_spider/hunter,
/turf/open/floor/iron,
/area/planet/ruin/engi_outpost)
"an" = (
/turf/open/floor/engine/n2,
/area/planet/ruin/engi_outpost)
"ao" = (
/obj/machinery/portable_atmospherics/canister/nitrogen,
/obj/machinery/light/small/directional/north,
/turf/open/floor/engine/n2,
/area/planet/ruin/engi_outpost)
"aq" = (
/obj/structure/table/reinforced/plastitaniumglass,
/turf/open/floor/iron,
/area/planet/ruin/engi_outpost)
"ar" = (
/obj/effect/mob_spawn/corpse/human/assistant,
/obj/item/construction/rcd,
/obj/structure/cable,
/turf/open/floor/catwalk_floor/iron,
/area/planet/ruin/engi_outpost)
"as" = (
/obj/machinery/modular_computer/console/preset/civilian{
	dir = 8
	},
/obj/effect/turf_decal/trimline/yellow/filled/warning{
	dir = 8
	},
/obj/structure/cable,
/turf/open/floor/iron,
/area/planet/ruin/engi_outpost)
"au" = (
/obj/machinery/rnd/production/circuit_imprinter/offstation,
/obj/effect/turf_decal/trimline/yellow/filled/warning{
	dir = 10
	},
/turf/open/floor/iron,
/area/planet/ruin/engi_outpost)
"av" = (
/obj/structure/cable,
/turf/open/floor/plating,
/area/planet/ruin/engi_outpost)
"aw" = (
/obj/machinery/light/directional/north,
/turf/open/floor/plating,
/area/planet/ruin/engi_outpost)
"ax" = (
/obj/structure/window/reinforced/spawner/east,
/obj/effect/turf_decal/siding/thinplating{
	dir = 4
	},
/obj/structure/statue/snow/snowman,
/turf/open/misc/snow/actually_safe,
/area/planet/ruin/engi_outpost)
"ay" = (
/obj/effect/turf_decal/stripes/line{
	dir = 1
	},
/obj/structure/table/reinforced/plastitaniumglass,
/obj/item/rcd_ammo,
/obj/item/rcd_ammo,
/turf/open/floor/iron,
/area/planet/ruin/engi_outpost)
"az" = (
/obj/effect/turf_decal/stripes/line{
	dir = 1
	},
/obj/structure/cable,
/turf/open/floor/iron,
/area/planet/ruin/engi_outpost)
"aA" = (
/obj/machinery/rnd/production/protolathe/department/engineering,
/obj/effect/turf_decal/trimline/yellow/filled/warning{
	dir = 9
	},
/obj/effect/turf_decal/stripes/line{
	dir = 1
	},
/obj/item/rcd_upgrade/frames,
/turf/open/floor/iron,
/area/planet/ruin/engi_outpost)
"aC" = (
/turf/open/floor/engine/o2,
/area/planet/ruin/engi_outpost)
"aD" = (
/obj/machinery/portable_atmospherics/canister/oxygen,
/obj/machinery/light/small/directional/north,
/turf/open/floor/engine/o2,
/area/planet/ruin/engi_outpost)
"aE" = (
/obj/structure/window/reinforced/spawner/east,
/obj/effect/turf_decal/siding/thinplating{
	dir = 4
	},
/obj/item/toy/snowball,
/turf/open/misc/snow/actually_safe,
/area/planet/ruin/engi_outpost)
"aF" = (
/obj/structure/cable,
/turf/open/floor/catwalk_floor/iron,
/area/planet/ruin/engi_outpost)
"aG" = (
/obj/machinery/atmospherics/components/unary/outlet_injector/on,
/turf/open/floor/engine/n2,
/area/planet/ruin/engi_outpost)
"aH" = (
/obj/machinery/atmospherics/pipe/smart/simple/scrubbers/visible{
	dir = 4
	},
/obj/machinery/light/directional/north,
/turf/open/floor/iron,
/area/planet/ruin/engi_outpost)
"aI" = (
/obj/machinery/atmospherics/pipe/smart/simple/yellow/visible,
/turf/open/floor/iron,
/area/planet/ruin/engi_outpost)
"aJ" = (
/obj/structure/cable,
/turf/open/floor/iron,
/area/planet/ruin/engi_outpost)
"aK" = (
/obj/machinery/atmospherics/components/unary/vent_pump/siphon/on,
/turf/open/floor/engine/n2,
/area/planet/ruin/engi_outpost)
"aL" = (
/obj/machinery/atmospherics/components/unary/outlet_injector/on,
/turf/open/floor/engine/o2,
/area/planet/ruin/engi_outpost)
"aM" = (
/obj/machinery/atmospherics/components/unary/vent_pump/siphon/on,
/turf/open/floor/engine/o2,
/area/planet/ruin/engi_outpost)
"aQ" = (
/obj/machinery/atmospherics/pipe/heat_exchanging/manifold{
	dir = 1
	},
/obj/effect/turf_decal/stripes/line{
	dir = 1
	},
/turf/open/floor/plating/icemoon,
/area/planet/ruin/engi_outpost)
"aR" = (
/obj/machinery/atmospherics/pipe/heat_exchanging/simple{
	dir = 10
	},
/obj/effect/turf_decal/stripes/line{
	dir = 5
	},
/turf/open/floor/plating/icemoon,
/area/planet/ruin/engi_outpost)
"aT" = (
/obj/structure/window/reinforced/spawner/east,
/obj/effect/turf_decal/siding/thinplating{
	dir = 4
	},
/turf/open/misc/snow/actually_safe,
/area/planet/ruin/engi_outpost)
"aV" = (
/obj/machinery/autolathe,
/turf/open/floor/iron,
/area/planet/ruin/engi_outpost)
"aW" = (
/obj/item/clothing/under/rank/engineering/chief_engineer,
/obj/structure/cable,
/turf/open/floor/iron,
/area/planet/ruin/engi_outpost)
"aX" = (
/obj/machinery/atmospherics/pipe/heat_exchanging/simple{
	dir = 10
	},
/obj/effect/turf_decal/stripes/line{
	dir = 4
	},
/turf/open/floor/plating/icemoon,
/area/planet/ruin/engi_outpost)
"ba" = (
/obj/effect/spawner/structure/window/reinforced,
/obj/machinery/door/firedoor/heavy,
/obj/machinery/atmospherics/pipe/smart/simple/cyan/visible,
/turf/open/floor/plating,
/area/planet/ruin/engi_outpost)
"bc" = (
/obj/machinery/atmospherics/pipe/smart/simple/yellow/visible{
	dir = 4
	},
/turf/open/floor/iron,
/area/planet/ruin/engi_outpost)
"be" = (
/obj/machinery/atmospherics/components/binary/pump,
/turf/open/floor/iron,
/area/planet/ruin/engi_outpost)
"bi" = (
/obj/machinery/atmospherics/components/unary/passive_vent{
	dir = 8
	},
/turf/open/floor/plating/icemoon,
/area/planet/ruin/engi_outpost)
"bj" = (
/obj/machinery/atmospherics/pipe/heat_exchanging/simple{
	dir = 5
	},
/turf/open/floor/plating/icemoon,
/area/planet/ruin/engi_outpost)
"bl" = (
/obj/machinery/atmospherics/pipe/heat_exchanging/manifold,
/turf/open/floor/plating/icemoon,
/area/planet/ruin/engi_outpost)
"bm" = (
/obj/machinery/atmospherics/pipe/heat_exchanging/manifold{
	dir = 4
	},
/obj/effect/turf_decal/stripes/line{
	dir = 4
	},
/turf/open/floor/plating/icemoon,
/area/planet/ruin/engi_outpost)
"bo" = (
/obj/effect/spawner/structure/window/reinforced,
/obj/machinery/door/firedoor/heavy,
/obj/machinery/atmospherics/pipe/smart/simple/yellow/visible,
/turf/open/floor/plating,
/area/planet/ruin/engi_outpost)
"bq" = (
/obj/machinery/door/airlock/engineering/glass{
	name = "Production Room"
	},
/obj/effect/mapping_helpers/airlock/access/all/away/engineering,
/obj/structure/cable,
/turf/open/floor/iron,
/area/planet/ruin/engi_outpost)
"br" = (
/obj/machinery/atmospherics/pipe/smart/simple/cyan/visible,
/obj/structure/sign/poster/official/build{
	pixel_x = -32
	},
/turf/open/floor/iron,
/area/planet/ruin/engi_outpost)
"bs" = (
/obj/machinery/atmospherics/pipe/smart/simple/scrubbers/visible{
	dir = 6
	},
/turf/open/floor/iron,
/area/planet/ruin/engi_outpost)
"bv" = (
/obj/machinery/atmospherics/pipe/smart/simple/scrubbers/visible{
	dir = 4
	},
/obj/machinery/atmospherics/pipe/bridge_pipe/yellow/visible,
/turf/open/floor/iron,
/area/planet/ruin/engi_outpost)
"bx" = (
/obj/machinery/atmospherics/components/trinary/filter/atmos/o2{
	dir = 8
	},
/turf/open/floor/iron,
/area/planet/ruin/engi_outpost)
"by" = (
/obj/machinery/airalarm/directional/west,
/turf/open/floor/iron,
/area/planet/ruin/engi_outpost)
"bz" = (
/obj/machinery/door/firedoor/heavy,
/turf/open/floor/iron,
/area/planet/ruin/engi_outpost)
"bA" = (
/obj/structure/window/reinforced/plasma/spawner,
/obj/structure/window/reinforced/plasma/spawner/north,
/obj/structure/window/reinforced/plasma/spawner/west,
/obj/machinery/atmospherics/components/unary/vent_scrubber{
	dir = 8
	},
/turf/open/floor/engine,
/area/planet/ruin/engi_outpost)
"bB" = (
/obj/structure/window/reinforced/plasma/spawner,
/obj/structure/window/reinforced/plasma/spawner/east,
/obj/structure/window/reinforced/plasma/spawner/north,
/obj/machinery/atmospherics/components/unary/vent_pump{
	dir = 4
	},
/turf/open/floor/engine,
/area/planet/ruin/engi_outpost)
"bF" = (
/obj/machinery/atmospherics/components/unary/portables_connector{
	dir = 8
	},
/obj/machinery/portable_atmospherics/canister/air,
/turf/open/floor/iron,
/area/planet/ruin/engi_outpost)
"bG" = (
/obj/effect/turf_decal/trimline/yellow/filled/line{
	dir = 8
	},
/obj/effect/turf_decal/trimline/blue/warning{
	dir = 8
	},
/turf/open/floor/iron,
/area/planet/ruin/engi_outpost)
"bH" = (
/obj/effect/turf_decal/trimline/yellow/filled/corner{
	dir = 4
	},
/turf/open/floor/iron,
/area/planet/ruin/engi_outpost)
"bI" = (
/obj/effect/turf_decal/trimline/yellow/filled/line{
	dir = 1
	},
/obj/structure/tank_dispenser,
/turf/open/floor/iron,
/area/planet/ruin/engi_outpost)
"bL" = (
/obj/machinery/atmospherics/components/trinary/filter/atmos/n2,
/turf/open/floor/iron,
/area/planet/ruin/engi_outpost)
"bM" = (
/obj/machinery/atmospherics/pipe/smart/simple/yellow/visible{
	dir = 6
	},
/turf/open/floor/iron,
/area/planet/ruin/engi_outpost)
"bQ" = (
/obj/machinery/atmospherics/pipe/smart/manifold/yellow/visible{
	dir = 4
	},
/turf/open/floor/iron,
/area/planet/ruin/engi_outpost)
"bR" = (
/obj/machinery/atmospherics/components/unary/portables_connector,
/turf/open/floor/iron,
/area/planet/ruin/engi_outpost)
"bS" = (
/obj/structure/table,
/obj/item/flashlight{
	pixel_y = 4
	},
/turf/open/floor/iron,
/area/planet/ruin/engi_outpost)
"bT" = (
/turf/open/floor/iron/corner{
	dir = 4
	},
/area/planet/ruin/engi_outpost)
"bV" = (
/obj/effect/turf_decal/trimline/yellow/filled/corner{
	dir = 1
	},
/obj/effect/turf_decal/trimline/blue/corner{
	dir = 1
	},
/turf/open/floor/iron,
/area/planet/ruin/engi_outpost)
"bW" = (
/obj/machinery/atmospherics/pipe/smart/simple/cyan/visible{
	dir = 6
	},
/turf/open/floor/iron,
/area/planet/ruin/engi_outpost)
"bY" = (
/obj/machinery/atmospherics/pipe/smart/simple/cyan/visible{
	dir = 4
	},
/obj/structure/cable,
/turf/open/floor/iron,
/area/planet/ruin/engi_outpost)
"bZ" = (
/obj/machinery/atmospherics/pipe/smart/simple/cyan/visible{
	dir = 4
	},
/turf/open/floor/iron,
/area/planet/ruin/engi_outpost)
"ca" = (
/obj/effect/spawner/structure/window/reinforced,
/obj/machinery/atmospherics/pipe/heat_exchanging/junction{
	dir = 4
	},
/turf/open/floor/plating,
/area/planet/ruin/engi_outpost)
"cb" = (
/obj/machinery/atmospherics/pipe/smart/simple/scrubbers/visible,
/turf/open/floor/iron,
/area/planet/ruin/engi_outpost)
"cc" = (
/obj/machinery/atmospherics/pipe/smart/manifold/yellow/visible{
	dir = 8
	},
/turf/open/floor/iron,
/area/planet/ruin/engi_outpost)
"cd" = (
/obj/machinery/atmospherics/components/trinary/mixer/airmix,
/turf/open/floor/iron,
/area/planet/ruin/engi_outpost)
"ce" = (
/obj/machinery/atmospherics/pipe/smart/simple/orange/visible{
	dir = 6
	},
/turf/open/floor/iron/corner,
/area/planet/ruin/engi_outpost)
"cf" = (
/obj/machinery/atmospherics/components/trinary/filter/flipped{
	dir = 8
	},
/turf/open/floor/iron,
/area/planet/ruin/engi_outpost)
"cg" = (
/obj/machinery/atmospherics/pipe/smart/simple/cyan/visible{
	dir = 5
	},
/turf/open/floor/iron,
/area/planet/ruin/engi_outpost)
"ch" = (
/obj/machinery/atmospherics/pipe/heat_exchanging/simple{
	dir = 9
	},
/obj/effect/turf_decal/stripes/line{
	dir = 6
	},
/turf/open/floor/plating/icemoon,
/area/planet/ruin/engi_outpost)
"ci" = (
/obj/machinery/power/energy_accumulator/grounding_rod/anchored,
/obj/machinery/atmospherics/pipe/smart/simple/scrubbers/visible{
	dir = 4
	},
/obj/structure/cable,
/turf/open/floor/iron,
/area/planet/ruin/engi_outpost)
"cj" = (
/obj/machinery/power/energy_accumulator/tesla_coil/anchored,
/obj/machinery/atmospherics/pipe/smart/simple/scrubbers/visible{
	dir = 4
	},
/obj/structure/cable,
/turf/open/floor/iron,
/area/planet/ruin/engi_outpost)
"ck" = (
/obj/machinery/atmospherics/components/binary/volume_pump{
	dir = 4
	},
/turf/open/floor/iron/corner{
	dir = 8
	},
/area/planet/ruin/engi_outpost)
"cl" = (
/obj/effect/spawner/structure/window/reinforced,
/obj/machinery/atmospherics/pipe/smart/simple/scrubbers/visible{
	dir = 4
	},
/turf/open/floor/plating,
/area/planet/ruin/engi_outpost)
"cm" = (
/obj/item/book/manual/wiki/atmospherics,
/obj/structure/table,
/turf/open/floor/iron,
/area/planet/ruin/engi_outpost)
"cn" = (
/obj/machinery/atmospherics/pipe/smart/simple/cyan/visible,
/turf/open/floor/iron,
/area/planet/ruin/engi_outpost)
"cp" = (
/obj/machinery/atmospherics/components/unary/portables_connector{
	dir = 1
	},
/turf/open/floor/iron,
/area/planet/ruin/engi_outpost)
"cs" = (
/obj/machinery/atmospherics/pipe/smart/simple/orange/visible{
	dir = 5
	},
/turf/open/floor/iron,
/area/planet/ruin/engi_outpost)
"ct" = (
/obj/structure/window/reinforced/plasma/spawner/north,
/obj/structure/cable,
/turf/open/floor/engine,
/area/planet/ruin/engi_outpost)
"cu" = (
/obj/machinery/atmospherics/pipe/smart/simple/cyan/visible{
	dir = 10
	},
/obj/machinery/light/directional/east,
/turf/open/floor/iron,
/area/planet/ruin/engi_outpost)
"cv" = (
/obj/machinery/atmospherics/pipe/heat_exchanging/simple{
	dir = 6
	},
/turf/open/floor/plating/icemoon,
/area/planet/ruin/engi_outpost)
"cx" = (
/obj/item/pipe_dispenser,
/turf/open/floor/iron,
/area/planet/ruin/engi_outpost)
"cD" = (
/obj/effect/spawner/structure/window/reinforced,
/obj/machinery/door/firedoor/heavy,
/obj/machinery/atmospherics/pipe/smart/simple/orange/visible/layer4,
/turf/open/floor/plating,
/area/planet/ruin/engi_outpost)
"cE" = (
/obj/effect/spawner/structure/window/reinforced,
/obj/machinery/door/firedoor/heavy,
/turf/open/floor/plating,
/area/planet/ruin/engi_outpost)
"cF" = (
/obj/machinery/door/airlock/engineering{
	name = "Engineering Access"
	},
/obj/effect/mapping_helpers/airlock/access/all/away/engineering,
/turf/open/floor/iron,
/area/planet/ruin/engi_outpost)
"cG" = (
/obj/effect/spawner/structure/window/reinforced,
/turf/open/floor/plating,
/area/planet/ruin/engi_outpost)
"cI" = (
/turf/open/floor/iron,
/area/planet/ruin/engi_outpost)
"cJ" = (
/obj/item/modular_computer/pda/engineering,
/turf/open/floor/iron,
/area/planet/ruin/engi_outpost)
"cL" = (
/obj/effect/decal/remains/human,
/obj/item/mod/control/pre_equipped/engineering,
/obj/effect/decal/cleanable/blood/old,
/obj/structure/cable,
/obj/effect/mapping_helpers/broken_floor,
/turf/open/floor/iron,
/area/planet/ruin/engi_outpost)
"cN" = (
/obj/machinery/atmospherics/pipe/smart/simple/cyan/visible,
/turf/open/floor/iron/corner{
	dir = 1
	},
/area/planet/ruin/engi_outpost)
"cO" = (
/obj/machinery/atmospherics/pipe/heat_exchanging/simple{
	dir = 4
	},
/turf/open/floor/plating/icemoon,
/area/planet/ruin/engi_outpost)
"cP" = (
/obj/machinery/atmospherics/components/binary/pump{
	dir = 1
	},
/turf/open/floor/iron,
/area/planet/ruin/engi_outpost)
"cQ" = (
/obj/machinery/atmospherics/pipe/smart/simple/cyan/visible{
	dir = 9
	},
/obj/machinery/atmospherics/pipe/smart/simple/orange/visible/layer4{
	dir = 6
	},
/turf/open/floor/iron,
/area/planet/ruin/engi_outpost)
"cR" = (
/obj/machinery/atmospherics/components/binary/pump/layer4{
	dir = 4
	},
/turf/open/floor/iron,
/area/planet/ruin/engi_outpost)
"cS" = (
/obj/machinery/atmospherics/components/unary/portables_connector/layer4{
	dir = 8
	},
/turf/open/floor/iron,
/area/planet/ruin/engi_outpost)
"cU" = (
/turf/open/floor/iron/icemoon,
/area/planet/ruin/engi_outpost)
"cV" = (
/obj/effect/turf_decal/trimline/yellow/filled/corner{
	dir = 8
	},
/obj/effect/turf_decal/trimline/blue/corner{
	dir = 8
	},
/turf/open/floor/iron,
/area/planet/ruin/engi_outpost)
"cW" = (
/obj/effect/mapping_helpers/broken_floor,
/turf/open/floor/iron,
/area/planet/ruin/engi_outpost)
"cX" = (
/obj/structure/cable,
/obj/machinery/power/emitter/welded{
	dir = 1
	},
/turf/open/floor/catwalk_floor/iron,
/area/planet/ruin/engi_outpost)
"cY" = (
/obj/item/stack/sheet/plasmarglass,
/obj/item/card/id/advanced/engioutpost,
/obj/effect/mapping_helpers/broken_floor,
/turf/open/floor/iron,
/area/planet/ruin/engi_outpost)
"cZ" = (
/obj/machinery/atmospherics/pipe/smart/simple/scrubbers/visible{
	dir = 5
	},
/turf/open/floor/iron,
/area/planet/ruin/engi_outpost)
"db" = (
/obj/machinery/atmospherics/pipe/smart/simple/scrubbers/visible{
	dir = 4
	},
/obj/machinery/atmospherics/pipe/bridge_pipe/cyan/visible,
/turf/open/floor/iron,
/area/planet/ruin/engi_outpost)
"de" = (
/turf/template_noop,
/area/template_noop)
"df" = (
/obj/machinery/atmospherics/pipe/smart/simple/scrubbers/visible{
	dir = 4
	},
/obj/structure/sign/poster/official/pda_ad{
	pixel_y = -32
	},
/turf/open/floor/iron,
/area/planet/ruin/engi_outpost)
"dg" = (
/obj/machinery/atmospherics/pipe/smart/simple/scrubbers/visible{
	dir = 4
	},
/obj/machinery/atmospherics/pipe/smart/simple/orange/visible/layer4,
/turf/open/floor/iron,
/area/planet/ruin/engi_outpost)
"dh" = (
/obj/machinery/atmospherics/pipe/smart/simple/scrubbers/visible{
	dir = 4
	},
/turf/open/floor/iron,
/area/planet/ruin/engi_outpost)
"di" = (
/obj/machinery/atmospherics/pipe/smart/simple/scrubbers/visible{
	dir = 10
	},
/turf/open/floor/iron,
/area/planet/ruin/engi_outpost)
"dj" = (
/obj/effect/turf_decal/trimline/yellow/filled/corner,
/turf/open/floor/iron,
/area/planet/ruin/engi_outpost)
"dk" = (
/obj/effect/turf_decal/trimline/yellow/filled/line,
/obj/effect/mapping_helpers/broken_floor,
/turf/open/floor/iron,
/area/planet/ruin/engi_outpost)
"dl" = (
/obj/effect/mob_spawn/corpse/human/engineer/mod,
/obj/effect/decal/cleanable/blood/tracks,
/turf/open/floor/plating/icemoon,
/area/planet/ruin/engi_outpost)
"dn" = (
/obj/effect/spawner/structure/window/reinforced,
/obj/machinery/door/firedoor/heavy,
/obj/machinery/atmospherics/pipe/smart/simple/scrubbers/visible,
/turf/open/floor/plating,
/area/planet/ruin/engi_outpost)
"do" = (
/turf/closed/wall,
/area/planet/ruin/engi_outpost)
"dp" = (
/turf/closed/wall/ice,
/area/planet/ruin/engi_outpost)
"dq" = (
/obj/effect/turf_decal/trimline/yellow/filled/line{
	dir = 8
	},
/obj/structure/reagent_dispensers/water_cooler,
/turf/open/floor/iron/icemoon,
/area/planet/ruin/engi_outpost)
"dr" = (
/obj/effect/turf_decal/tile/yellow{
	dir = 1
	},
/obj/effect/decal/cleanable/blood/old,
/turf/open/floor/iron/icemoon,
/area/planet/ruin/engi_outpost)
"ds" = (
/obj/effect/turf_decal/trimline/yellow/filled/line{
	dir = 4
	},
/turf/open/floor/iron/icemoon,
/area/planet/ruin/engi_outpost)
"dt" = (
/obj/structure/table/reinforced,
/obj/machinery/door/firedoor/closed,
/obj/item/shard,
/turf/open/floor/plating,
/area/planet/ruin/engi_outpost)
"du" = (
/obj/effect/decal/cleanable/blood/tracks,
/turf/open/floor/plating/icemoon,
/area/planet/ruin/engi_outpost)
"dv" = (
/obj/machinery/atmospherics/components/unary/vent_pump/siphon/on{
	dir = 1
	},
/turf/open/floor/engine/air,
/area/planet/ruin/engi_outpost)
"dw" = (
/turf/open/floor/engine/air,
/area/planet/ruin/engi_outpost)
"dx" = (
/obj/machinery/atmospherics/components/unary/outlet_injector/on{
	dir = 1
	},
/turf/open/floor/engine/air,
/area/planet/ruin/engi_outpost)
"dy" = (
/obj/machinery/atmospherics/components/unary/vent_pump/siphon/on/layer4{
	dir = 1
	},
/turf/open/floor/engine/vacuum,
/area/planet/ruin/engi_outpost)
"dz" = (
/turf/open/floor/engine/vacuum,
/area/planet/ruin/engi_outpost)
"dA" = (
/obj/machinery/atmospherics/components/unary/outlet_injector/on{
	dir = 1
	},
/turf/open/floor/engine/vacuum,
/area/planet/ruin/engi_outpost)
"dB" = (
/obj/effect/turf_decal/trimline/yellow/filled/line{
	dir = 8
	},
/obj/structure/chair/sofa/bench/left{
	dir = 4
	},
/obj/structure/sign/poster/contraband/grey_tide{
	pixel_y = 32
	},
/turf/open/floor/iron/icemoon,
/area/planet/ruin/engi_outpost)
"dC" = (
/obj/machinery/airalarm/directional/north,
/obj/effect/turf_decal/trimline/yellow/filled/line{
	dir = 4
	},
/obj/structure/chair/sofa/bench/right{
	dir = 8
	},
/turf/open/floor/iron/icemoon,
/area/planet/ruin/engi_outpost)
"dD" = (
/turf/closed/wall/rust,
/area/planet/ruin/engi_outpost)
"dE" = (
/obj/effect/decal/cleanable/blood/tracks{
	dir = 9
	},
/turf/open/floor/plating/icemoon,
/area/planet/ruin/engi_outpost)
"gK" = (
/obj/effect/decal/cleanable/blood/tracks{
	dir = 4
	},
/turf/open/floor/plating/icemoon,
/area/planet/ruin/engi_outpost)
"kS" = (
/obj/effect/turf_decal/tile/yellow,
/obj/effect/turf_decal/box/corners{
	dir = 1
	},
/turf/open/floor/iron/icemoon,
/area/planet/ruin/engi_outpost)
"na" = (
/obj/effect/decal/cleanable/blood/tracks{
	dir = 6
	},
/turf/open/floor/plating/icemoon,
/area/planet/ruin/engi_outpost)
"sc" = (
/obj/effect/turf_decal/trimline/yellow/filled/line{
	dir = 4
	},
/obj/structure/chair/sofa/bench/left{
	dir = 8
	},
/turf/open/floor/iron/icemoon,
/area/planet/ruin/engi_outpost)
"tH" = (
/obj/machinery/portable_atmospherics/canister/air,
/obj/machinery/light/small/directional/south,
/turf/open/floor/engine/air,
/area/planet/ruin/engi_outpost)
"xA" = (
/obj/machinery/portable_atmospherics/canister,
/obj/machinery/light/small/directional/south,
/turf/open/floor/engine/vacuum,
/area/planet/ruin/engi_outpost)
"Ai" = (
/mob/living/simple_animal/hostile/giant_spider/tarantula,
/turf/open/floor/iron,
/area/planet/ruin/engi_outpost)
"CH" = (
/obj/effect/turf_decal/tile/yellow,
/obj/effect/mob_spawn/corpse/human/engineer/mod,
/obj/effect/decal/cleanable/blood/old,
/turf/open/floor/iron/icemoon,
/area/planet/ruin/engi_outpost)
"CV" = (
/obj/machinery/atmospherics/pipe/heat_exchanging/simple{
	dir = 9
	},
/obj/effect/turf_decal/stripes/line{
	dir = 4
	},
/turf/open/floor/plating/icemoon,
/area/planet/ruin/engi_outpost)
"EL" = (
/obj/machinery/atmospherics/pipe/heat_exchanging/simple{
	dir = 4
	},
/obj/effect/turf_decal/stripes/line{
	dir = 1
	},
/turf/open/floor/plating/icemoon,
/area/planet/ruin/engi_outpost)
"GG" = (
/obj/effect/turf_decal/tile/yellow,
/turf/open/floor/iron/icemoon,
/area/planet/ruin/engi_outpost)
"Iy" = (
/obj/effect/turf_decal/tile/yellow,
/mob/living/simple_animal/hostile/giant_spider/tarantula,
/turf/open/floor/iron/icemoon,
/area/planet/ruin/engi_outpost)
"Je" = (
/obj/structure/door_assembly/door_assembly_eng,
/turf/open/floor/iron/icemoon,
/area/planet/ruin/engi_outpost)
"KU" = (
/obj/machinery/atmospherics/pipe/heat_exchanging/simple{
	dir = 4
	},
/obj/effect/turf_decal/stripes/line,
/turf/open/floor/plating/icemoon,
/area/planet/ruin/engi_outpost)
"Lh" = (
/obj/effect/turf_decal/siding/thinplating{
	dir = 1
	},
/turf/open/floor/plating/icemoon,
/area/planet/ruin/engi_outpost)
"Nd" = (
/obj/structure/girder/displaced,
/obj/effect/turf_decal/tile/yellow{
	dir = 1
	},
/obj/effect/turf_decal/box/corners,
/turf/open/floor/iron/icemoon,
/area/planet/ruin/engi_outpost)
"UK" = (
/obj/effect/turf_decal/trimline/yellow/filled/line{
	dir = 8
	},
/obj/structure/chair/sofa/bench/right{
	dir = 4
	},
/obj/machinery/light/directional/west,
/turf/open/floor/iron/icemoon,
/area/planet/ruin/engi_outpost)
"Wh" = (
/obj/effect/turf_decal/tile/yellow{
	dir = 1
	},
/turf/open/floor/iron/icemoon,
/area/planet/ruin/engi_outpost)

(1,1,1) = {"
de
de
do
do
do
do
do
cE
cE
dD
cE
cE
do
do
do
do
do
de
de
"}
(2,1,1) = {"
de
de
do
an
aG
ba
br
cg
cI
by
bR
cP
aI
bo
dv
dw
do
de
de
"}
(3,1,1) = {"
de
de
dD
ao
an
cE
bs
bL
cb
cb
cb
cb
cZ
cE
dw
tH
dD
de
de
"}
(4,1,1) = {"
de
de
dD
an
aK
bo
bv
aI
cc
be
cp
bW
db
ba
dx
dw
do
de
de
"}
(5,1,1) = {"
de
de
dD
do
do
do
aH
Ai
bc
cm
bS
bZ
df
dD
dD
do
do
de
de
"}
(6,1,1) = {"
de
de
do
aC
aL
ba
bx
bM
cd
cn
cn
cQ
dg
cD
dy
dz
do
de
de
"}
(7,1,1) = {"
de
de
do
aD
aC
cE
bF
bc
cI
cI
cx
cR
dh
cE
dz
xA
do
de
de
"}
(8,1,1) = {"
de
de
do
aC
aM
bo
aI
bQ
be
cp
cI
cS
di
dn
dA
dz
do
de
de
"}
(9,1,1) = {"
de
do
do
do
do
do
cE
dD
bz
bz
bz
do
cE
do
do
do
dp
do
de
"}
(10,1,1) = {"
dD
do
ax
aE
aT
do
bG
bV
ce
cs
bT
cV
bG
do
dB
UK
dq
dD
de
"}
(11,1,1) = {"
dD
ag
ay
aq
aV
cG
cI
bW
cf
bA
cJ
cW
cI
cG
cU
kS
Wh
Je
de
"}
(12,1,1) = {"
do
av
az
aF
aW
bq
aJ
bY
ci
ct
cL
cX
cI
cF
cU
CH
Wh
do
de
"}
(13,1,1) = {"
do
aw
am
ar
cI
cG
bH
bZ
cj
bB
cW
cY
dj
cG
cU
Iy
dr
do
de
"}
(14,1,1) = {"
do
ah
aA
as
au
cG
bI
bZ
ck
cu
cN
cg
dk
dt
cU
GG
Nd
do
de
"}
(15,1,1) = {"
do
do
do
do
dD
do
do
ca
cl
do
cG
ca
dD
dD
dC
sc
ds
Lh
gK
"}
(16,1,1) = {"
de
de
de
de
de
de
de
EL
bi
cv
bj
KU
de
do
dD
do
do
do
gK
"}
(17,1,1) = {"
de
de
de
de
de
de
de
aQ
bj
cO
cO
KU
de
de
dE
du
du
de
de
"}
(18,1,1) = {"
de
de
de
de
de
de
de
aQ
bl
cO
cO
KU
dl
du
na
de
de
de
de
"}
(19,1,1) = {"
de
de
de
de
de
de
de
aQ
bl
cO
cO
KU
de
de
de
de
de
de
de
"}
(20,1,1) = {"
de
de
de
de
de
de
de
aR
bm
CV
aX
ch
de
de
de
de
de
de
de
"}
