//MAP CONVERTED BY dmm2tgm.py THIS HEADER COMMENT PREVENTS RECONVERSION, DO NOT REMOVE
"a" = (
/obj/effect/mapping_helpers/broken_floor,
/obj/structure/closet/crate,
/obj/effect/spawner/random/contraband/armory,
/turf/open/floor/mineral/titanium/icemoon,
/area/planet/ruin/crashed_shuttle)
"b" = (
/obj/structure/low_wall/titanium,
/obj/item/shard,
/turf/open/floor/plating/icemoon,
/area/planet/ruin/crashed_shuttle)
"c" = (
/obj/effect/mapping_helpers/broken_floor,
/obj/effect/decal/cleanable/glass,
/obj/effect/decal/cleanable/blood/gibs/torso,
/turf/open/floor/mineral/plastitanium/red/icemoon,
/area/planet/ruin/crashed_shuttle)
"d" = (
/turf/closed/wall/mineral/titanium,
/area/planet/ruin/crashed_shuttle)
"g" = (
/obj/structure/shuttle/engine/propulsion,
/turf/open/floor/plating/icemoon,
/area/planet/ruin/crashed_shuttle)
"i" = (
/obj/structure/frame/machine/wired/anchored,
/turf/open/floor/plating/icemoon,
/area/planet/ruin/crashed_shuttle)
"l" = (
/obj/effect/mapping_helpers/broken_floor,
/obj/effect/decal/cleanable/glass,
/obj/effect/spawner/random/ore_rich,
/turf/open/floor/mineral/titanium/icemoon,
/area/planet/ruin/crashed_shuttle)
"m" = (
/obj/structure/shuttle/engine/heater,
/turf/open/floor/plating/icemoon,
/area/planet/ruin/crashed_shuttle)
"n" = (
/obj/structure/table_frame,
/obj/item/stack/sheet/iron,
/obj/item/stack/cable_coil/cut,
/obj/effect/spawner/random/maintenance,
/turf/open/floor/plating/icemoon,
/area/planet/ruin/crashed_shuttle)
"o" = (
/obj/item/stack/cable_coil/cut,
/obj/effect/mapping_helpers/broken_floor,
/turf/open/floor/plating/icemoon,
/area/planet/ruin/crashed_shuttle)
"p" = (
/obj/effect/spawner/structure/window/reinforced/shuttle,
/turf/open/floor/plating/icemoon,
/area/planet/ruin/crashed_shuttle)
"s" = (
/obj/effect/mapping_helpers/broken_floor,
/obj/effect/decal/cleanable/glass,
/obj/effect/decal/cleanable/blood/gibs/down,
/turf/open/floor/plating/icemoon,
/area/planet/ruin/crashed_shuttle)
"t" = (
/obj/effect/mapping_helpers/broken_floor,
/obj/item/shell/airlock,
/turf/open/floor/plating,
/area/planet/ruin/crashed_shuttle)
"u" = (
/obj/effect/decal/cleanable/glass,
/obj/effect/mapping_helpers/broken_floor,
/obj/item/light/tube/broken,
/turf/open/floor/mineral/plastitanium/red/icemoon,
/area/planet/ruin/crashed_shuttle)
"v" = (
/obj/structure/frame/machine/wired,
/obj/item/circuitboard/machine/stacking_machine,
/obj/effect/mapping_helpers/broken_floor,
/turf/open/floor/plating/icemoon,
/area/planet/ruin/crashed_shuttle)
"x" = (
/obj/effect/mapping_helpers/broken_floor,
/obj/effect/decal/cleanable/glass,
/obj/item/shard,
/obj/item/electronics/airlock,
/obj/effect/decal/cleanable/blood/gibs/core,
/turf/open/floor/plating/icemoon,
/area/planet/ruin/crashed_shuttle)
"z" = (
/obj/effect/decal/cleanable/glass,
/obj/item/shard,
/turf/open/floor/plating/icemoon,
/area/planet/ruin/crashed_shuttle)
"A" = (
/obj/structure/low_wall/titanium,
/turf/open/floor/plating/icemoon,
/area/planet/ruin/crashed_shuttle)
"C" = (
/obj/effect/mapping_helpers/broken_floor,
/obj/effect/spawner/random/maintenance,
/turf/open/floor/mineral/titanium/icemoon,
/area/planet/ruin/crashed_shuttle)
"D" = (
/obj/structure/reagent_dispensers/wall/peppertank/directional/west,
/obj/structure/frame/computer{
	dir = 4
	},
/obj/item/shard,
/obj/effect/decal/cleanable/glass,
/obj/item/stack/cable_coil/cut,
/turf/open/floor/plating/icemoon,
/area/planet/ruin/crashed_shuttle)
"E" = (
/obj/item/folder/red,
/obj/effect/mapping_helpers/broken_floor,
/obj/effect/decal/cleanable/glass,
/obj/effect/decal/cleanable/blood/gibs/up,
/turf/open/floor/plating/icemoon,
/area/planet/ruin/crashed_shuttle)
"F" = (
/obj/item/shard,
/obj/item/stack/sheet/mineral/titanium,
/obj/effect/mapping_helpers/broken_floor,
/obj/structure/grille/broken,
/turf/open/floor/plating/icemoon,
/area/planet/ruin/crashed_shuttle)
"H" = (
/obj/structure/shuttle/engine/heater,
/obj/structure/window/reinforced{
	dir = 1;
	layer = 2.9
	},
/turf/open/floor/plating/icemoon,
/area/planet/ruin/crashed_shuttle)
"I" = (
/obj/structure/girder,
/turf/open/floor/plating/icemoon,
/area/planet/ruin/crashed_shuttle)
"P" = (
/obj/item/shell/airlock,
/obj/item/electronics/airlock,
/obj/item/stack/cable_coil/cut,
/turf/open/floor/plating/icemoon,
/area/planet/ruin/crashed_shuttle)
"Q" = (
/obj/effect/mapping_helpers/broken_floor,
/obj/item/shard,
/obj/effect/decal/cleanable/glass,
/obj/effect/decal/cleanable/blood/gibs,
/obj/effect/decal/cleanable/blood/footprints{
	dir = 4
	},
/turf/open/floor/plating/icemoon,
/area/planet/ruin/crashed_shuttle)
"U" = (
/obj/item/stack/sheet/mineral/titanium,
/obj/item/assembly/flash,
/obj/item/stack/cable_coil/cut,
/obj/effect/mapping_helpers/broken_floor,
/obj/effect/decal/cleanable/blood/gibs/limb,
/turf/open/floor/mineral/titanium/icemoon,
/area/planet/ruin/crashed_shuttle)
"W" = (
/obj/item/stack/sheet/iron,
/obj/effect/mapping_helpers/broken_floor,
/obj/effect/decal/cleanable/glass,
/obj/effect/decal/cleanable/blood/gibs/limb,
/turf/open/floor/mineral/plastitanium/red/icemoon,
/area/planet/ruin/crashed_shuttle)
"X" = (
/obj/item/restraints/handcuffs,
/obj/item/shard,
/obj/effect/mapping_helpers/broken_floor,
/turf/open/floor/plating/icemoon,
/area/planet/ruin/crashed_shuttle)

(1,1,1) = {"
d
d
p
d
d
F
A
d
d
"}
(2,1,1) = {"
b
D
u
c
s
Q
z
m
i
"}
(3,1,1) = {"
b
E
X
I
a
x
l
m
g
"}
(4,1,1) = {"
p
n
W
v
C
U
t
H
g
"}
(5,1,1) = {"
d
d
P
d
d
d
o
d
d
"}
