//MAP CONVERTED BY dmm2tgm.py THIS HEADER COMMENT PREVENTS RECONVERSION, DO NOT REMOVE
"am" = (
/obj/effect/decal/cleanable/glass,
/obj/effect/turf_decal/stripes/line{
	dir = 5
	},
/obj/effect/decal/cleanable/dirt,
/obj/machinery/atmospherics/pipe/smart/manifold4w/supply/hidden/layer4,
/turf/open/floor/iron/icemoon,
/area/planet/ruin/mining_facility)
"aS" = (
/obj/machinery/door/poddoor/preopen{
	dir = 4
	},
/obj/effect/decal/cleanable/dirt,
/obj/effect/turf_decal/stripes/line{
	dir = 4
	},
/obj/effect/turf_decal/stripes/line{
	dir = 8
	},
/obj/effect/mapping_helpers/broken_floor,
/turf/open/floor/plating/icemoon,
/area/planet/ruin/mining_facility)
"bF" = (
/obj/machinery/mineral/processing_unit_console,
/turf/closed/wall,
/area/planet/ruin/mining_facility)
"bT" = (
/obj/structure/closet,
/obj/effect/turf_decal/box,
/obj/effect/spawner/random/engineering/material,
/obj/effect/spawner/random/engineering/material_rare,
/turf/open/floor/iron/dark/icemoon,
/area/planet/ruin/mining_facility)
"dd" = (
/obj/effect/decal/cleanable/dirt,
/obj/effect/turf_decal/delivery,
/turf/open/floor/iron/icemoon,
/area/planet/ruin/mining_facility)
"dn" = (
/obj/structure/closet/firecloset,
/obj/effect/turf_decal/box,
/obj/effect/decal/cleanable/cobweb,
/obj/effect/decal/cleanable/dirt,
/obj/machinery/light/small/broken/directional/north,
/turf/open/floor/iron/dark/icemoon,
/area/planet/ruin/mining_facility)
"ec" = (
/obj/effect/turf_decal/stripes/line{
	dir = 1
	},
/obj/effect/turf_decal/stripes/corner,
/turf/open/floor/iron/icemoon,
/area/planet/ruin/mining_facility)
"fS" = (
/obj/effect/turf_decal/stripes/line{
	dir = 1
	},
/obj/effect/turf_decal/stripes/line,
/obj/effect/decal/cleanable/dirt,
/turf/open/floor/iron/icemoon,
/area/planet/ruin/mining_facility)
"gE" = (
/obj/machinery/mineral/equipment_vendor,
/obj/effect/mapping_helpers/broken_machine,
/obj/effect/decal/cleanable/cobweb,
/obj/effect/decal/cleanable/dirt,
/obj/effect/turf_decal/delivery,
/turf/open/floor/iron/dark/icemoon,
/area/planet/ruin/mining_facility)
"hi" = (
/obj/effect/decal/cleanable/dirt,
/obj/effect/turf_decal/loading_area{
	dir = 8
	},
/turf/open/floor/iron/dark/icemoon,
/area/planet/ruin/mining_facility)
"hu" = (
/obj/item/shard,
/obj/effect/decal/cleanable/glass,
/obj/effect/turf_decal/stripes/line{
	dir = 10
	},
/obj/effect/mapping_helpers/broken_floor,
/obj/effect/decal/cleanable/dirt,
/turf/open/floor/iron/icemoon,
/area/planet/ruin/mining_facility)
"hL" = (
/obj/machinery/door/poddoor/preopen{
	dir = 4
	},
/obj/effect/turf_decal/stripes/line{
	dir = 4
	},
/obj/effect/turf_decal/stripes/line{
	dir = 8
	},
/turf/open/floor/plating/icemoon,
/area/planet/ruin/mining_facility)
"iu" = (
/obj/effect/spawner/structure/window,
/obj/structure/barricade/wooden/crude,
/turf/open/floor/plating/icemoon,
/area/planet/ruin/mining_facility)
"jd" = (
/turf/closed/wall/rust,
/area/planet/ruin/mining_facility)
"je" = (
/turf/closed/wall/r_wall/rust,
/area/planet/ruin/mining_facility)
"jg" = (
/obj/effect/decal/cleanable/dirt,
/obj/effect/mapping_helpers/broken_floor,
/obj/machinery/atmospherics/components/unary/vent_scrubber/layer2{
	dir = 4
	},
/turf/open/floor/plating/icemoon,
/area/planet/ruin/mining_facility)
"jr" = (
/obj/effect/decal/cleanable/cobweb/cobweb2,
/obj/machinery/suit_storage_unit/mining,
/obj/effect/turf_decal/delivery,
/turf/open/floor/iron/dark/icemoon,
/area/planet/ruin/mining_facility)
"ka" = (
/obj/effect/decal/cleanable/dirt,
/obj/structure/rack,
/obj/effect/turf_decal/delivery,
/obj/effect/spawner/random/maintenance/three,
/obj/item/metal_density_scanner,
/obj/machinery/light/broken/directional/east,
/turf/open/floor/iron/dark/icemoon,
/area/planet/ruin/mining_facility)
"lq" = (
/obj/effect/turf_decal/bot,
/obj/machinery/conveyor_switch/oneway{
	id = "outpost"
	},
/obj/effect/decal/cleanable/dirt,
/turf/open/floor/iron/dark/icemoon,
/area/planet/ruin/mining_facility)
"ly" = (
/obj/effect/turf_decal/stripes/corner{
	dir = 8
	},
/obj/effect/spawner/random/trash/garbage,
/obj/machinery/atmospherics/components/unary/vent_scrubber/layer2{
	dir = 1
	},
/turf/open/floor/plating/icemoon,
/area/planet/ruin/mining_facility)
"lA" = (
/obj/item/shard,
/obj/effect/turf_decal/stripes/line{
	dir = 10
	},
/obj/effect/decal/cleanable/dirt,
/turf/open/floor/iron/icemoon,
/area/planet/ruin/mining_facility)
"mj" = (
/obj/effect/decal/cleanable/dirt,
/obj/effect/mapping_helpers/broken_floor,
/turf/open/floor/plating/icemoon,
/area/planet/ruin/mining_facility)
"mm" = (
/obj/effect/turf_decal/delivery,
/obj/machinery/power/mining_drill,
/turf/open/floor/plating/icemoon,
/area/planet/ruin/mining_facility)
"mC" = (
/obj/effect/turf_decal/stripes/corner{
	dir = 4
	},
/obj/machinery/atmospherics/pipe/smart/manifold4w/scrubbers/hidden/layer2,
/obj/effect/spawner/random/ore,
/obj/machinery/atmospherics/components/unary/vent_pump/layer4{
	dir = 4
	},
/turf/open/floor/iron/icemoon,
/area/planet/ruin/mining_facility)
"mV" = (
/obj/machinery/portable_atmospherics/canister,
/obj/machinery/atmospherics/components/unary/portables_connector/visible/layer2{
	dir = 8
	},
/obj/effect/turf_decal/delivery,
/turf/open/floor/iron/dark/icemoon,
/area/planet/ruin/mining_facility)
"nA" = (
/obj/effect/decal/cleanable/dirt,
/obj/effect/turf_decal/stripes/line{
	dir = 6
	},
/obj/machinery/atmospherics/pipe/smart/manifold4w/scrubbers/hidden/layer2,
/obj/machinery/atmospherics/components/unary/vent_pump/layer4,
/turf/open/floor/plating/icemoon,
/area/planet/ruin/mining_facility)
"nE" = (
/obj/machinery/conveyor{
	dir = 5;
	id = "outpost"
	},
/obj/effect/decal/cleanable/cobweb,
/obj/effect/decal/cleanable/dirt,
/turf/open/floor/plating/icemoon,
/area/planet/ruin/mining_facility)
"nF" = (
/obj/effect/decal/cleanable/dirt,
/obj/effect/mapping_helpers/broken_floor,
/obj/effect/turf_decal/stripes/line{
	dir = 10
	},
/turf/open/floor/iron/dark/icemoon,
/area/planet/ruin/mining_facility)
"nL" = (
/obj/effect/turf_decal/stripes/line{
	dir = 8
	},
/obj/effect/decal/cleanable/dirt,
/obj/effect/mapping_helpers/broken_floor,
/turf/open/floor/iron/icemoon,
/area/planet/ruin/mining_facility)
"nP" = (
/obj/effect/turf_decal/stripes/line{
	dir = 1
	},
/obj/structure/ore_box,
/obj/effect/decal/cleanable/dirt,
/obj/machinery/atmospherics/pipe/smart/manifold4w/scrubbers/hidden/layer2,
/obj/machinery/atmospherics/pipe/smart/manifold4w/supply/hidden/layer4,
/turf/open/floor/iron/icemoon,
/area/planet/ruin/mining_facility)
"ol" = (
/turf/closed/wall/r_wall,
/area/planet/ruin/mining_facility)
"om" = (
/obj/machinery/conveyor{
	dir = 6;
	id = "outpost"
	},
/obj/effect/decal/cleanable/cobweb/cobweb2,
/turf/open/floor/plating/icemoon,
/area/planet/ruin/mining_facility)
"pJ" = (
/obj/effect/turf_decal/stripes/line,
/obj/effect/decal/cleanable/dirt,
/obj/effect/spawner/random/ore,
/turf/open/floor/iron/icemoon,
/area/planet/ruin/mining_facility)
"pN" = (
/obj/effect/turf_decal/loading_area{
	dir = 8
	},
/obj/effect/decal/cleanable/dirt,
/obj/machinery/atmospherics/pipe/smart/manifold4w/scrubbers/hidden/layer2,
/turf/open/floor/plating/icemoon,
/area/planet/ruin/mining_facility)
"pT" = (
/obj/effect/spawner/structure/window,
/turf/open/floor/plating/icemoon,
/area/planet/ruin/mining_facility)
"qB" = (
/obj/structure/table/glass,
/obj/effect/spawner/random/contraband/armory,
/obj/effect/turf_decal/bot,
/turf/open/floor/iron/dark/icemoon,
/area/planet/ruin/mining_facility)
"qG" = (
/obj/effect/turf_decal/stripes/line{
	dir = 1
	},
/obj/effect/decal/cleanable/dirt,
/obj/machinery/atmospherics/pipe/smart/manifold4w/scrubbers/hidden/layer2,
/obj/machinery/atmospherics/pipe/smart/manifold4w/supply/hidden/layer4,
/turf/open/floor/plating/icemoon,
/area/planet/ruin/mining_facility)
"qI" = (
/obj/effect/turf_decal/stripes/line{
	dir = 1
	},
/obj/effect/turf_decal/stripes/line,
/obj/effect/decal/cleanable/dirt,
/obj/effect/mapping_helpers/broken_floor,
/turf/open/floor/iron/icemoon,
/area/planet/ruin/mining_facility)
"qN" = (
/obj/effect/turf_decal/stripes/line{
	dir = 1
	},
/obj/item/stack/cable_coil/cut,
/obj/machinery/atmospherics/pipe/smart/manifold4w/scrubbers/hidden/layer2,
/obj/machinery/atmospherics/pipe/smart/manifold4w/supply/hidden/layer4,
/turf/open/floor/iron/icemoon,
/area/planet/ruin/mining_facility)
"rA" = (
/obj/effect/decal/cleanable/dirt,
/obj/effect/mapping_helpers/broken_floor,
/turf/open/floor/iron/icemoon,
/area/planet/ruin/mining_facility)
"rS" = (
/obj/effect/turf_decal/stripes/line{
	dir = 4
	},
/obj/effect/turf_decal/stripes/line{
	dir = 8
	},
/obj/effect/mapping_helpers/broken_floor,
/turf/open/floor/iron/icemoon,
/area/planet/ruin/mining_facility)
"rX" = (
/obj/effect/turf_decal/stripes/line{
	dir = 4
	},
/obj/effect/turf_decal/stripes/corner{
	dir = 1
	},
/obj/effect/decal/cleanable/dirt,
/obj/machinery/atmospherics/pipe/smart/manifold4w/scrubbers/hidden/layer2,
/obj/machinery/atmospherics/pipe/smart/manifold4w/supply/hidden/layer4,
/turf/open/floor/iron/icemoon,
/area/planet/ruin/mining_facility)
"sQ" = (
/obj/effect/decal/cleanable/dirt,
/obj/effect/mapping_helpers/broken_floor,
/obj/machinery/suit_storage_unit/mining,
/obj/effect/turf_decal/delivery,
/turf/open/floor/iron/dark/icemoon,
/area/planet/ruin/mining_facility)
"tD" = (
/obj/effect/turf_decal/stripes/line{
	dir = 9
	},
/obj/effect/mapping_helpers/broken_floor,
/obj/effect/spawner/random/ore,
/turf/open/floor/plating/icemoon,
/area/planet/ruin/mining_facility)
"uI" = (
/obj/effect/decal/cleanable/dirt,
/obj/effect/turf_decal/delivery,
/obj/machinery/power/mining_drill,
/turf/open/floor/plating/icemoon,
/area/planet/ruin/mining_facility)
"uR" = (
/obj/structure/table_frame,
/obj/item/shard,
/obj/effect/decal/cleanable/glass,
/obj/effect/spawner/random/material,
/obj/effect/spawner/random/material_scarce,
/obj/effect/turf_decal/bot,
/turf/open/floor/iron/dark/icemoon,
/area/planet/ruin/mining_facility)
"xs" = (
/obj/effect/turf_decal/stripes/corner{
	dir = 4
	},
/obj/machinery/holopad,
/obj/effect/mapping_helpers/broken_machine,
/obj/effect/decal/cleanable/dirt,
/obj/machinery/atmospherics/pipe/smart/manifold4w/scrubbers/hidden/layer2,
/obj/machinery/atmospherics/pipe/smart/manifold4w/supply/hidden/layer4,
/obj/effect/mob_spawn/corpse/human/cargo_tech,
/turf/open/floor/iron/icemoon,
/area/planet/ruin/mining_facility)
"xw" = (
/obj/machinery/light/broken/directional/north,
/obj/effect/decal/cleanable/dirt,
/obj/effect/mapping_helpers/broken_floor,
/obj/effect/turf_decal/stripes/line{
	dir = 5
	},
/obj/effect/spawner/random/ore,
/obj/machinery/atmospherics/components/unary/vent_scrubber/layer2,
/turf/open/floor/iron/dark/icemoon,
/area/planet/ruin/mining_facility)
"yO" = (
/obj/machinery/portable_atmospherics/canister/air,
/obj/machinery/atmospherics/components/unary/portables_connector/visible{
	dir = 8
	},
/obj/effect/turf_decal/delivery,
/obj/effect/decal/cleanable/cobweb/cobweb2,
/turf/open/floor/iron/dark/icemoon,
/area/planet/ruin/mining_facility)
"zv" = (
/obj/effect/turf_decal/stripes/line{
	dir = 6
	},
/obj/effect/decal/cleanable/dirt,
/turf/open/floor/plating/icemoon,
/area/planet/ruin/mining_facility)
"zy" = (
/obj/machinery/conveyor{
	dir = 4;
	id = "outpost"
	},
/obj/machinery/light/small/broken/directional/north,
/obj/effect/decal/cleanable/dirt,
/turf/open/floor/plating/icemoon,
/area/planet/ruin/mining_facility)
"zz" = (
/obj/effect/turf_decal/stripes/line{
	dir = 4
	},
/obj/effect/mapping_helpers/broken_floor,
/turf/open/floor/iron/icemoon,
/area/planet/ruin/mining_facility)
"zB" = (
/obj/structure/frame/machine/wired,
/obj/item/stock_parts/manipulator{
	pixel_y = 4;
	pixel_x = 4
	},
/obj/item/stock_parts/matter_bin{
	pixel_y = 9;
	pixel_x = -7
	},
/obj/item/circuitboard/machine/autolathe{
	pixel_y = -5
	},
/obj/effect/decal/cleanable/glass,
/obj/effect/turf_decal/bot,
/obj/effect/decal/cleanable/dirt,
/turf/open/floor/plating/icemoon,
/area/planet/ruin/mining_facility)
"Au" = (
/obj/structure/closet/crate{
	icon_state = "crateopen"
	},
/obj/effect/spawner/random/maintenance/four,
/obj/effect/decal/cleanable/dirt,
/turf/open/floor/iron/dark/icemoon,
/area/planet/ruin/mining_facility)
"AH" = (
/obj/effect/spawner/random/structure/crate_loot,
/obj/effect/turf_decal/bot,
/obj/effect/mapping_helpers/broken_floor,
/turf/open/floor/iron/icemoon,
/area/planet/ruin/mining_facility)
"Bs" = (
/obj/effect/turf_decal/stripes/line{
	dir = 10
	},
/obj/machinery/light/small/broken/directional/south,
/obj/machinery/mining_brace,
/turf/open/floor/iron/icemoon,
/area/planet/ruin/mining_facility)
"BW" = (
/obj/machinery/mech_bay_recharge_port{
	dir = 8
	},
/obj/effect/mapping_helpers/broken_machine,
/obj/effect/decal/cleanable/dirt,
/turf/open/floor/iron/icemoon,
/area/planet/ruin/mining_facility)
"CV" = (
/obj/effect/turf_decal/stripes/line{
	dir = 1
	},
/obj/effect/decal/cleanable/dirt,
/turf/open/floor/iron/icemoon,
/area/planet/ruin/mining_facility)
"Di" = (
/obj/machinery/light/broken/directional/south,
/obj/structure/closet,
/obj/effect/turf_decal/box,
/obj/effect/decal/cleanable/dirt,
/obj/effect/spawner/random/engineering/material_rare,
/obj/effect/spawner/random/engineering/material_rare,
/obj/effect/spawner/random/engineering/material,
/turf/open/floor/plating/icemoon,
/area/planet/ruin/mining_facility)
"Dp" = (
/obj/effect/turf_decal/stripes/line{
	dir = 4
	},
/obj/effect/mapping_helpers/broken_floor,
/obj/effect/turf_decal/stripes/corner{
	dir = 1
	},
/obj/item/knife,
/obj/machinery/atmospherics/pipe/smart/manifold4w/scrubbers/hidden/layer2,
/obj/machinery/atmospherics/pipe/smart/manifold4w/supply/hidden/layer4,
/turf/open/floor/iron/icemoon,
/area/planet/ruin/mining_facility)
"DN" = (
/obj/effect/turf_decal/stripes/line,
/obj/effect/decal/cleanable/dirt,
/turf/open/floor/plating/icemoon,
/area/planet/ruin/mining_facility)
"Ec" = (
/obj/structure/closet,
/obj/effect/turf_decal/box,
/obj/effect/mapping_helpers/broken_floor,
/obj/effect/decal/cleanable/dirt,
/obj/effect/spawner/random/engineering/material,
/obj/effect/spawner/random/engineering/material_cheap,
/turf/open/floor/iron/dark/icemoon,
/area/planet/ruin/mining_facility)
"ER" = (
/obj/machinery/mining_brace,
/obj/effect/turf_decal/bot,
/obj/effect/mapping_helpers/broken_floor,
/turf/open/floor/iron/dark/icemoon,
/area/planet/ruin/mining_facility)
"Fa" = (
/obj/effect/turf_decal/stripes/line{
	dir = 9
	},
/obj/effect/decal/cleanable/dirt,
/obj/effect/mapping_helpers/broken_floor,
/turf/open/floor/iron/icemoon,
/area/planet/ruin/mining_facility)
"Gh" = (
/turf/template_noop,
/area/template_noop)
"GD" = (
/obj/effect/turf_decal/delivery,
/obj/effect/decal/cleanable/dirt,
/obj/effect/mapping_helpers/broken_floor,
/obj/effect/spawner/random/ore,
/obj/effect/spawner/random/ore,
/obj/effect/spawner/random/ore_rich,
/turf/open/floor/iron/dark/icemoon,
/area/planet/ruin/mining_facility)
"Jt" = (
/obj/structure/frame/computer{
	dir = 4
	},
/obj/item/shard,
/obj/item/stack/cable_coil/cut,
/obj/effect/decal/cleanable/glass,
/obj/effect/turf_decal/bot,
/turf/open/floor/iron/dark/icemoon,
/area/planet/ruin/mining_facility)
"Ju" = (
/obj/effect/decal/cleanable/dirt,
/obj/effect/turf_decal/stripes/line{
	dir = 9
	},
/obj/effect/spawner/random/maintenance/two,
/turf/open/floor/plating/icemoon,
/area/planet/ruin/mining_facility)
"Jv" = (
/obj/effect/turf_decal/loading_area{
	dir = 8
	},
/obj/effect/mapping_helpers/broken_floor,
/obj/effect/decal/cleanable/dirt,
/obj/effect/decal/cleanable/dirt,
/obj/effect/spawner/random/trash/garbage,
/obj/effect/mob_spawn/corpse/human/cargo_tech,
/obj/machinery/atmospherics/pipe/smart/manifold4w/supply/hidden/layer4,
/turf/open/floor/iron/dark/icemoon,
/area/planet/ruin/mining_facility)
"Kf" = (
/obj/machinery/mineral/unloading_machine{
	icon_state = "unloader-corner"
	},
/turf/open/floor/plating/icemoon,
/area/planet/ruin/mining_facility)
"Kh" = (
/obj/effect/spawner/random/structure/barricade,
/obj/machinery/door/airlock/mining/glass{
	dir = 4
	},
/obj/machinery/atmospherics/pipe/smart/manifold4w/scrubbers/hidden/layer2,
/obj/machinery/atmospherics/pipe/smart/manifold4w/supply/hidden/layer4,
/turf/open/floor/plating/icemoon,
/area/planet/ruin/mining_facility)
"Kj" = (
/obj/effect/turf_decal/stripes/line,
/obj/effect/mapping_helpers/broken_floor,
/turf/open/floor/plating/icemoon,
/area/planet/ruin/mining_facility)
"Kw" = (
/obj/machinery/light/small/built/directional/north,
/obj/machinery/conveyor{
	dir = 4;
	id = "outpost"
	},
/obj/effect/decal/cleanable/dirt,
/obj/effect/spawner/random/material,
/turf/open/floor/plating/icemoon,
/area/planet/ruin/mining_facility)
"KA" = (
/obj/effect/turf_decal/loading_area{
	dir = 8
	},
/obj/effect/spawner/random/ore,
/turf/open/floor/plating/icemoon,
/area/planet/ruin/mining_facility)
"Lh" = (
/obj/effect/decal/cleanable/dirt,
/obj/structure/mecha_wreckage/ripley,
/obj/effect/mapping_helpers/broken_floor,
/turf/open/floor/iron/recharge_floor/icemoon,
/area/planet/ruin/mining_facility)
"Lr" = (
/obj/effect/mapping_helpers/broken_floor,
/turf/open/floor/iron/icemoon,
/area/planet/ruin/mining_facility)
"Ml" = (
/obj/effect/spawner/random/structure/crate_loot,
/obj/effect/decal/cleanable/dirt,
/obj/effect/turf_decal/bot,
/turf/open/floor/iron/icemoon,
/area/planet/ruin/mining_facility)
"MM" = (
/obj/effect/turf_decal/loading_area{
	dir = 8
	},
/obj/effect/decal/cleanable/dirt,
/turf/open/floor/plating/icemoon,
/area/planet/ruin/mining_facility)
"Nc" = (
/obj/effect/decal/cleanable/dirt,
/turf/open/floor/iron/dark/icemoon,
/area/planet/ruin/mining_facility)
"Nh" = (
/obj/effect/spawner/structure/window/reinforced,
/turf/open/floor/plating/icemoon,
/area/planet/ruin/mining_facility)
"NJ" = (
/obj/machinery/mineral/processing_unit{
	dir = 8
	},
/obj/machinery/conveyor{
	dir = 4;
	id = "outpost"
	},
/obj/effect/decal/cleanable/dirt,
/turf/open/floor/plating/icemoon,
/area/planet/ruin/mining_facility)
"Oc" = (
/obj/effect/turf_decal/stripes/line{
	dir = 8
	},
/obj/effect/mapping_helpers/broken_floor,
/obj/machinery/atmospherics/pipe/smart/manifold4w/scrubbers/hidden/layer2,
/obj/machinery/atmospherics/pipe/smart/manifold4w/supply/hidden/layer4,
/turf/open/floor/iron/icemoon,
/area/planet/ruin/mining_facility)
"Ox" = (
/obj/machinery/door/poddoor/preopen{
	dir = 4
	},
/obj/effect/decal/cleanable/dirt,
/obj/effect/turf_decal/stripes/line{
	dir = 4
	},
/obj/effect/turf_decal/stripes/line{
	dir = 8
	},
/turf/open/floor/plating/icemoon,
/area/planet/ruin/mining_facility)
"OW" = (
/obj/structure/tank_dispenser/oxygen,
/obj/effect/turf_decal/delivery,
/turf/open/floor/iron/dark/icemoon,
/area/planet/ruin/mining_facility)
"PR" = (
/obj/effect/turf_decal/stripes/line{
	dir = 1
	},
/obj/effect/turf_decal/stripes/line,
/obj/effect/decal/cleanable/dirt,
/obj/effect/spawner/random/ore,
/turf/open/floor/plating/icemoon,
/area/planet/ruin/mining_facility)
"Qg" = (
/obj/structure/ore_box,
/obj/effect/decal/cleanable/dirt,
/obj/effect/turf_decal/delivery,
/turf/open/floor/iron/icemoon,
/area/planet/ruin/mining_facility)
"Qp" = (
/obj/machinery/door/airlock/mining,
/obj/machinery/atmospherics/pipe/smart/manifold4w/scrubbers/hidden/layer2,
/obj/machinery/atmospherics/pipe/smart/manifold4w/supply/hidden/layer4,
/turf/open/floor/plating/icemoon,
/area/planet/ruin/mining_facility)
"RA" = (
/obj/effect/turf_decal/stripes/end{
	dir = 1
	},
/obj/effect/decal/cleanable/dirt,
/obj/machinery/atmospherics/pipe/smart/manifold4w/scrubbers/hidden/layer2,
/obj/machinery/atmospherics/pipe/smart/manifold4w/supply/hidden/layer4,
/turf/open/floor/iron/icemoon,
/area/planet/ruin/mining_facility)
"RE" = (
/turf/closed/wall,
/area/planet/ruin/mining_facility)
"SC" = (
/obj/effect/turf_decal/stripes/line{
	dir = 8
	},
/obj/effect/spawner/random/ore,
/turf/open/floor/plating/icemoon,
/area/planet/ruin/mining_facility)
"SQ" = (
/obj/effect/turf_decal/stripes/line,
/obj/effect/decal/cleanable/dirt,
/obj/effect/spawner/random/trash/garbage,
/turf/open/floor/plating/icemoon,
/area/planet/ruin/mining_facility)
"SV" = (
/obj/effect/decal/cleanable/dirt,
/obj/structure/rack,
/obj/effect/turf_decal/delivery,
/obj/effect/spawner/random/maintenance/seven,
/turf/open/floor/plating/icemoon,
/area/planet/ruin/mining_facility)
"Tn" = (
/obj/effect/turf_decal/loading_area,
/obj/effect/decal/cleanable/dirt,
/obj/effect/spawner/random/material,
/obj/effect/spawner/random/material,
/obj/effect/spawner/random/material_scarce,
/turf/open/floor/iron/dark/icemoon,
/area/planet/ruin/mining_facility)
"UB" = (
/obj/effect/turf_decal/stripes/line,
/obj/effect/decal/cleanable/dirt,
/turf/open/floor/iron/icemoon,
/area/planet/ruin/mining_facility)
"UU" = (
/obj/effect/turf_decal/stripes/line{
	dir = 6
	},
/obj/effect/mapping_helpers/broken_floor,
/turf/open/floor/iron/icemoon,
/area/planet/ruin/mining_facility)
"Vz" = (
/obj/structure/closet/emcloset,
/obj/effect/turf_decal/box,
/obj/effect/decal/cleanable/cobweb,
/obj/effect/decal/cleanable/dirt,
/turf/open/floor/iron/dark/icemoon,
/area/planet/ruin/mining_facility)
"Wb" = (
/obj/structure/plasticflaps,
/turf/open/floor/plating/icemoon,
/area/planet/ruin/mining_facility)
"WQ" = (
/obj/machinery/computer/mech_bay_power_console{
	dir = 8
	},
/obj/effect/mapping_helpers/broken_machine,
/obj/effect/decal/cleanable/dirt,
/turf/open/floor/plating/icemoon,
/area/planet/ruin/mining_facility)
"WR" = (
/obj/effect/decal/cleanable/dirt,
/obj/effect/spawner/random/structure/crate_loot,
/obj/effect/turf_decal/bot,
/obj/effect/mapping_helpers/broken_floor,
/turf/open/floor/iron/dark/icemoon,
/area/planet/ruin/mining_facility)
"WT" = (
/obj/machinery/atmospherics/components/unary/outlet_injector/on/layer2{
	dir = 8
	},
/turf/open/floor/plating/icemoon,
/area/planet/ruin/mining_facility)
"Xu" = (
/obj/effect/turf_decal/stripes/line{
	dir = 4
	},
/obj/effect/decal/cleanable/dirt,
/obj/effect/spawner/random/trash/garbage,
/obj/effect/mapping_helpers/broken_floor,
/turf/open/floor/iron/icemoon,
/area/planet/ruin/mining_facility)
"XJ" = (
/obj/effect/decal/cleanable/dirt,
/obj/machinery/mining_brace,
/obj/effect/turf_decal/bot,
/obj/effect/mapping_helpers/broken_floor,
/turf/open/floor/iron/dark/icemoon,
/area/planet/ruin/mining_facility)
"Yw" = (
/obj/effect/spawner/structure/window/reinforced,
/obj/structure/barricade/wooden/crude,
/turf/open/floor/plating/icemoon,
/area/planet/ruin/mining_facility)
"Yz" = (
/obj/effect/turf_decal/stripes/line{
	dir = 4
	},
/obj/effect/mapping_helpers/broken_floor,
/obj/effect/decal/cleanable/dirt,
/obj/effect/spawner/random/ore,
/obj/machinery/atmospherics/components/unary/vent_pump/layer4{
	dir = 1
	},
/turf/open/floor/iron/icemoon,
/area/planet/ruin/mining_facility)
"YE" = (
/obj/effect/turf_decal/stripes/line{
	dir = 5
	},
/obj/effect/turf_decal/stripes/corner{
	dir = 8
	},
/obj/effect/decal/cleanable/cobweb/cobweb2,
/obj/effect/decal/cleanable/dirt,
/obj/machinery/airalarm/directional/north,
/obj/machinery/light/broken/directional/east,
/obj/effect/spawner/random/ore,
/turf/open/floor/plating/icemoon,
/area/planet/ruin/mining_facility)
"YV" = (
/obj/effect/decal/cleanable/dirt,
/obj/machinery/mining_brace,
/obj/effect/turf_decal/bot,
/obj/machinery/light/broken/directional/south,
/turf/open/floor/plating/icemoon,
/area/planet/ruin/mining_facility)

(1,1,1) = {"
Gh
Gh
je
je
Ox
aS
hL
aS
je
je
Gh
Gh
"}
(2,1,1) = {"
je
je
ol
dn
Fa
SC
nL
nL
Bs
je
ol
ol
"}
(3,1,1) = {"
je
nE
Kf
GD
CV
AH
jg
Ml
Kj
Nc
YV
je
"}
(4,1,1) = {"
ol
zy
pT
MM
ec
Xu
mC
Lr
DN
WR
mm
Nh
"}
(5,1,1) = {"
je
NJ
bF
lq
fS
WQ
nP
dd
pJ
mj
ER
Nh
"}
(6,1,1) = {"
ol
Kw
pT
Au
qI
Lh
qG
rA
UB
XJ
uI
Nh
"}
(7,1,1) = {"
je
om
Wb
Tn
PR
BW
qN
Qg
SQ
KA
hi
Nh
"}
(8,1,1) = {"
je
jd
RE
jd
YE
rS
rX
zz
UU
ka
SV
je
"}
(9,1,1) = {"
je
gE
OW
jd
jd
iu
Kh
iu
iu
jd
RE
je
"}
(10,1,1) = {"
ol
Ju
nF
RE
Vz
tD
Oc
lA
Jt
zB
je
Gh
"}
(11,1,1) = {"
je
xw
nA
Qp
RA
Dp
xs
ly
hu
Di
ol
Gh
"}
(12,1,1) = {"
je
jr
sQ
jd
Jv
pN
am
Yz
zv
bT
je
Gh
"}
(13,1,1) = {"
ol
je
ol
je
yO
mV
uR
qB
Ec
je
ol
Gh
"}
(14,1,1) = {"
Gh
Gh
Gh
ol
je
Yw
Yw
Yw
je
ol
Gh
Gh
"}
(15,1,1) = {"
Gh
Gh
Gh
Gh
Gh
Gh
WT
Gh
Gh
Gh
Gh
Gh
"}
