//MAP CONVERTED BY dmm2tgm.py THIS HEADER COMMENT PREVENTS RECONVERSION, DO NOT REMOVE
"aj" = (
/turf/closed/wall/mineral/titanium,
/area/shuttle/supply)
"aI" = (
/obj/effect/decal/cleanable/dirt,
/obj/effect/decal/cleanable/greenglow,
/obj/effect/landmark/cargo_shuttle_crate,
/turf/open/floor/plating/airless,
/area/shuttle/supply)
"bw" = (
/obj/effect/turf_decal/stripes/line,
/obj/effect/decal/cleanable/dirt,
/obj/machinery/atmospherics/pipe/smart/manifold4w/orange/visible,
/obj/machinery/meter,
/turf/open/floor/plating/airless,
/area/shuttle/supply)
"ck" = (
/obj/effect/turf_decal/stripes/orange/line{
	dir = 5
	},
/obj/effect/turf_decal/stripes/orange/corner{
	dir = 8
	},
/turf/open/floor/iron/dark/textured/airless,
/area/shuttle/supply)
"cV" = (
/obj/effect/turf_decal/stripes/orange/box,
/obj/machinery/door/bulkhead/external{
	dir = 4
	},
/obj/structure/fans/tiny,
/turf/open/floor/mineral/plastitanium,
/area/shuttle/supply)
"el" = (
/obj/effect/turf_decal/stripes/orange/line{
	dir = 9
	},
/obj/effect/turf_decal/stripes/orange/corner,
/turf/open/floor/iron/dark/textured/airless,
/area/shuttle/supply)
"eL" = (
/obj/effect/decal/cleanable/dirt,
/obj/effect/landmark/cargo_shuttle_crate,
/obj/effect/mapping_helpers/broken_floor,
/turf/open/floor/plating/airless,
/area/shuttle/supply)
"fF" = (
/obj/effect/turf_decal/stripes/orange/line{
	dir = 8
	},
/obj/effect/turf_decal/stripes/orange/line{
	dir = 4
	},
/obj/effect/turf_decal/caution/stand_clear/orange{
	dir = 8
	},
/turf/open/floor/iron/dark/textured/airless,
/area/shuttle/supply)
"fQ" = (
/obj/structure/shuttle/engine/heater,
/obj/machinery/atmospherics/pipe/smart/manifold4w/orange/visible,
/obj/effect/spawner/structure/window/reinforced/plasma/plastitanium,
/turf/open/floor/plating,
/area/shuttle/supply)
"he" = (
/obj/effect/turf_decal/stripes/line{
	dir = 9
	},
/obj/structure/railing{
	dir = 9
	},
/obj/effect/decal/cleanable/dirt,
/obj/effect/landmark/cargo_shuttle_crate,
/obj/effect/mapping_helpers/broken_floor,
/turf/open/floor/plating/airless,
/area/shuttle/supply)
"hh" = (
/obj/structure/lattice/catwalk,
/obj/docking_port/mobile/supply{
	dir = 4
	},
/turf/template_noop,
/area/shuttle/supply)
"hr" = (
/obj/effect/turf_decal/stripes/orange/line{
	dir = 6
	},
/obj/effect/mapping_helpers/broken_floor,
/obj/structure/chair/plastic{
	dir = 8
	},
/turf/open/floor/iron/dark/textured/airless,
/area/shuttle/supply)
"ia" = (
/obj/effect/turf_decal/box/corners,
/obj/effect/decal/cleanable/dirt,
/obj/effect/landmark/cargo_shuttle_crate,
/turf/open/floor/plating/airless,
/area/shuttle/supply)
"iO" = (
/obj/effect/turf_decal/stripes/orange/line{
	dir = 5
	},
/obj/structure/chair/plastic{
	dir = 8
	},
/turf/open/floor/iron/dark/textured/airless,
/area/shuttle/supply)
"kx" = (
/turf/template_noop,
/area/template_noop)
"la" = (
/obj/effect/turf_decal/stripes/line{
	dir = 9
	},
/obj/structure/railing{
	dir = 9
	},
/obj/effect/decal/cleanable/dirt,
/obj/effect/mapping_helpers/broken_floor,
/obj/structure/rack,
/obj/effect/mapping_helpers/broken_floor,
/turf/open/floor/plating/airless,
/area/shuttle/supply)
"lX" = (
/obj/effect/turf_decal/stripes/corner{
	dir = 1
	},
/obj/effect/decal/cleanable/dirt,
/obj/effect/decal/cleanable/insectguts,
/obj/effect/landmark/cargo_shuttle_crate,
/turf/open/floor/plating/airless,
/area/shuttle/supply)
"mG" = (
/obj/effect/turf_decal/stripes/line{
	dir = 1
	},
/obj/structure/railing{
	dir = 1
	},
/obj/effect/decal/cleanable/dirt,
/obj/effect/mapping_helpers/broken_floor,
/obj/structure/rack,
/obj/effect/mapping_helpers/broken_floor,
/turf/open/floor/plating/airless,
/area/shuttle/supply)
"mY" = (
/obj/effect/turf_decal/stripes/line,
/obj/effect/decal/cleanable/dirt,
/obj/machinery/atmospherics/pipe/smart/manifold4w/orange/visible,
/obj/effect/mapping_helpers/broken_floor,
/turf/open/floor/plating/airless,
/area/shuttle/supply)
"oU" = (
/obj/effect/turf_decal/stripes/orange/line{
	dir = 8
	},
/obj/effect/turf_decal/stripes/orange/corner{
	dir = 4
	},
/turf/open/floor/iron/dark/textured/airless,
/area/shuttle/supply)
"oZ" = (
/obj/effect/turf_decal/stripes/line{
	dir = 8
	},
/obj/effect/decal/cleanable/dirt,
/obj/effect/landmark/cargo_shuttle_crate,
/obj/effect/mapping_helpers/broken_floor,
/turf/open/floor/plating/airless,
/area/shuttle/supply)
"po" = (
/obj/effect/turf_decal/box/corners{
	dir = 1
	},
/obj/effect/decal/cleanable/dirt,
/obj/effect/landmark/cargo_shuttle_crate,
/obj/effect/mapping_helpers/broken_floor,
/turf/open/floor/plating/airless,
/area/shuttle/supply)
"pA" = (
/obj/structure/lattice,
/turf/template_noop,
/area/shuttle/supply)
"qa" = (
/obj/effect/turf_decal/stripes/orange/line{
	dir = 8
	},
/obj/effect/turf_decal/stripes/orange/line{
	dir = 4
	},
/obj/effect/turf_decal/caution/orange{
	dir = 8
	},
/turf/open/floor/iron/dark/textured/airless,
/area/shuttle/supply)
"qJ" = (
/obj/effect/turf_decal/stripes/orange/line{
	dir = 6
	},
/obj/effect/turf_decal/stripes/orange/corner{
	dir = 1
	},
/turf/open/floor/iron/dark/textured/airless,
/area/shuttle/supply)
"rg" = (
/obj/effect/turf_decal/caution/orange{
	dir = 4
	},
/obj/effect/turf_decal/stripes/orange/line{
	dir = 10
	},
/turf/open/floor/iron/dark/textured/airless,
/area/shuttle/supply)
"rX" = (
/turf/closed/wall/mineral/plastitanium,
/area/shuttle/supply)
"sS" = (
/obj/effect/turf_decal/stripes/line{
	dir = 5
	},
/obj/structure/railing{
	dir = 5
	},
/obj/effect/decal/cleanable/dirt,
/obj/effect/mapping_helpers/broken_floor,
/obj/effect/landmark/cargo_shuttle_crate,
/turf/open/floor/plating/airless,
/area/shuttle/supply)
"tr" = (
/obj/effect/decal/cleanable/dirt,
/obj/effect/landmark/cargo_shuttle_crate,
/turf/open/floor/plating/airless,
/area/shuttle/supply)
"vn" = (
/obj/structure/table,
/obj/effect/turf_decal/tile/neutral/fourcorners,
/obj/effect/turf_decal/bot,
/obj/effect/spawner/random/trash/garbage,
/obj/effect/spawner/random/trash/garbage,
/turf/open/floor/iron/dark/textured,
/area/shuttle/supply)
"wR" = (
/obj/effect/turf_decal/stripes/line{
	dir = 4
	},
/obj/effect/decal/cleanable/dirt,
/obj/effect/decal/cleanable/insectguts,
/obj/effect/landmark/cargo_shuttle_crate,
/turf/open/floor/plating/airless,
/area/shuttle/supply)
"xT" = (
/obj/structure/chair/comfy/shuttle{
	dir = 1
	},
/obj/effect/turf_decal/stripes/line{
	dir = 9
	},
/obj/machinery/light/directional/west,
/turf/open/floor/mineral/plastitanium,
/area/shuttle/supply)
"yA" = (
/obj/effect/turf_decal/stripes/line{
	dir = 6
	},
/obj/effect/decal/cleanable/dirt,
/obj/structure/railing{
	dir = 4
	},
/obj/machinery/atmospherics/pipe/smart/manifold4w/orange/visible,
/obj/effect/mapping_helpers/broken_floor,
/turf/open/floor/plating/airless,
/area/shuttle/supply)
"AF" = (
/obj/effect/turf_decal/stripes/line{
	dir = 10
	},
/obj/effect/decal/cleanable/dirt,
/obj/structure/railing{
	dir = 8
	},
/obj/machinery/atmospherics/pipe/smart/manifold4w/orange/visible,
/obj/effect/mapping_helpers/broken_floor,
/turf/open/floor/plating/airless,
/area/shuttle/supply)
"CI" = (
/obj/effect/turf_decal/stripes/line{
	dir = 8
	},
/obj/effect/decal/cleanable/dirt,
/obj/effect/landmark/cargo_shuttle_crate,
/turf/open/floor/plating/airless,
/area/shuttle/supply)
"Ed" = (
/obj/effect/turf_decal/box/corners{
	dir = 8
	},
/obj/effect/decal/cleanable/dirt,
/obj/effect/landmark/cargo_shuttle_crate,
/turf/open/floor/plating/airless,
/area/shuttle/supply)
"Fr" = (
/obj/effect/turf_decal/stripes/orange/end,
/turf/open/floor/iron/dark/textured/airless,
/area/shuttle/supply)
"Gp" = (
/obj/effect/turf_decal/stripes/orange/line{
	dir = 1
	},
/obj/effect/turf_decal/stripes/orange/line,
/turf/open/floor/iron/dark/textured/airless,
/area/shuttle/supply)
"HQ" = (
/obj/effect/decal/cleanable/dirt,
/obj/effect/landmark/cargo_shuttle_crate,
/obj/effect/decal/cleanable/oil,
/turf/open/floor/plating/airless,
/area/shuttle/supply)
"If" = (
/obj/effect/turf_decal/stripes/orange/box,
/turf/open/floor/mineral/plastitanium,
/area/shuttle/supply)
"Jv" = (
/obj/machinery/atmospherics/components/unary/engine,
/obj/effect/turf_decal/stripes/orange/line,
/turf/open/floor/plating/airless,
/area/shuttle/supply)
"JB" = (
/obj/effect/turf_decal/stripes/orange/line{
	dir = 10
	},
/obj/effect/turf_decal/stripes/orange/corner{
	dir = 4
	},
/obj/effect/mapping_helpers/broken_floor,
/turf/open/floor/iron/dark/textured/airless,
/area/shuttle/supply)
"Ke" = (
/obj/effect/turf_decal/tile/neutral/fourcorners,
/obj/effect/turf_decal/bot,
/obj/machinery/computer{
	name = "defunct computer";
	desc = "One day... one day."
	},
/turf/open/floor/iron/dark/textured,
/area/shuttle/supply)
"Kl" = (
/obj/effect/turf_decal/stripes/line{
	dir = 10
	},
/turf/open/floor/mineral/plastitanium,
/area/shuttle/supply)
"KE" = (
/obj/structure/marker_beacon/burgundy,
/obj/effect/turf_decal/delivery/red,
/obj/effect/turf_decal/stripes/orange/line{
	dir = 9
	},
/obj/effect/turf_decal/stripes/orange/corner,
/turf/open/floor/iron/dark/textured/airless,
/area/shuttle/supply)
"KF" = (
/obj/effect/turf_decal/box/corners{
	dir = 4
	},
/obj/effect/decal/cleanable/dirt,
/obj/effect/mapping_helpers/broken_floor,
/obj/effect/landmark/cargo_shuttle_crate,
/turf/open/floor/plating/airless,
/area/shuttle/supply)
"Nl" = (
/obj/structure/marker_beacon/burgundy,
/obj/effect/turf_decal/delivery/red,
/obj/effect/turf_decal/stripes/orange/line{
	dir = 5
	},
/obj/effect/turf_decal/stripes/orange/corner{
	dir = 8
	},
/turf/open/floor/iron/dark/textured/airless,
/area/shuttle/supply)
"ND" = (
/obj/effect/turf_decal/stripes/line{
	dir = 4
	},
/obj/effect/decal/cleanable/dirt,
/obj/effect/landmark/cargo_shuttle_crate,
/turf/open/floor/plating/airless,
/area/shuttle/supply)
"Pg" = (
/obj/structure/sign/warning/fire/directional/north,
/turf/template_noop,
/area/template_noop)
"PW" = (
/obj/effect/turf_decal/stripes/corner{
	dir = 4
	},
/obj/effect/decal/cleanable/dirt,
/obj/effect/landmark/cargo_shuttle_crate,
/turf/open/floor/plating/airless,
/area/shuttle/supply)
"Rv" = (
/obj/structure/lattice/catwalk,
/turf/template_noop,
/area/shuttle/supply)
"SY" = (
/obj/effect/turf_decal/stripes/line{
	dir = 4
	},
/obj/structure/railing/corner/end/flip,
/obj/effect/decal/cleanable/dirt,
/obj/machinery/atmospherics/pipe/smart/manifold4w/orange/visible,
/obj/effect/landmark/cargo_shuttle_crate,
/obj/effect/mapping_helpers/broken_floor,
/turf/open/floor/plating/airless,
/area/shuttle/supply)
"TD" = (
/obj/effect/turf_decal/stripes/line{
	dir = 4
	},
/obj/effect/decal/cleanable/dirt,
/obj/effect/mapping_helpers/broken_floor,
/obj/effect/landmark/cargo_shuttle_crate,
/turf/open/floor/plating/airless,
/area/shuttle/supply)
"TE" = (
/obj/effect/turf_decal/stripes/line{
	dir = 5
	},
/obj/structure/railing{
	dir = 5
	},
/obj/effect/decal/cleanable/dirt,
/obj/structure/rack,
/turf/open/floor/plating/airless,
/area/shuttle/supply)
"TH" = (
/obj/effect/spawner/structure/window/reinforced/shuttle,
/turf/open/floor/plating,
/area/shuttle/supply)
"TM" = (
/obj/effect/turf_decal/stripes/line{
	dir = 8
	},
/obj/effect/decal/cleanable/dirt,
/obj/effect/mapping_helpers/broken_floor,
/obj/effect/landmark/cargo_shuttle_crate,
/turf/open/floor/plating/airless,
/area/shuttle/supply)
"Uc" = (
/obj/effect/turf_decal/stripes/line{
	dir = 8
	},
/obj/structure/railing/corner/end{
	dir = 2
	},
/obj/effect/decal/cleanable/dirt,
/obj/effect/landmark/cargo_shuttle_crate,
/turf/open/floor/plating/airless,
/area/shuttle/supply)
"Vp" = (
/obj/effect/turf_decal/stripes/orange/line{
	dir = 8
	},
/obj/effect/turf_decal/stripes/orange/line{
	dir = 4
	},
/turf/open/floor/iron/dark/textured/airless,
/area/shuttle/supply)
"Wt" = (
/obj/effect/turf_decal/delivery/red,
/obj/effect/turf_decal/stripes/orange/end{
	dir = 1
	},
/obj/machinery/atmospherics/pipe/smart/manifold4w/orange/visible,
/turf/open/floor/iron/dark/textured/airless,
/area/shuttle/supply)
"XB" = (
/obj/effect/decal/cleanable/dirt,
/obj/effect/mapping_helpers/broken_floor,
/obj/effect/landmark/cargo_shuttle_crate,
/turf/open/floor/plating/airless,
/area/shuttle/supply)
"YZ" = (
/obj/effect/turf_decal/delivery/red,
/obj/effect/turf_decal/stripes/orange/end,
/obj/machinery/atmospherics/components/unary/portables_connector/visible/auto_connect{
	dir = 1
	},
/obj/machinery/portable_atmospherics/canister/carbon_dioxide,
/turf/open/floor/iron/dark/textured/airless,
/area/shuttle/supply)

(1,1,1) = {"
kx
kx
pA
Rv
Rv
hh
Rv
Rv
Rv
rX
Pg
"}
(2,1,1) = {"
kx
el
Vp
qa
Vp
fF
Vp
qa
Fr
rX
rX
"}
(3,1,1) = {"
KE
qJ
he
CI
TM
TM
oZ
Uc
AF
fQ
Jv
"}
(4,1,1) = {"
Gp
la
lX
po
tr
XB
aI
Ed
mY
fQ
Jv
"}
(5,1,1) = {"
Gp
mG
eL
tr
eL
tr
XB
XB
bw
rX
rX
"}
(6,1,1) = {"
Gp
TE
PW
KF
HQ
tr
tr
ia
mY
fQ
Jv
"}
(7,1,1) = {"
Nl
JB
sS
ND
ND
wR
TD
SY
yA
fQ
Jv
"}
(8,1,1) = {"
kx
ck
oU
rg
aj
cV
aj
Wt
YZ
rX
rX
"}
(9,1,1) = {"
kx
pA
iO
hr
aj
If
aj
aj
aj
rX
Pg
"}
(10,1,1) = {"
kx
pA
aj
aj
aj
cV
aj
aj
pA
kx
kx
"}
(11,1,1) = {"
kx
kx
TH
Ke
xT
Kl
vn
aj
pA
kx
kx
"}
(12,1,1) = {"
kx
kx
aj
aj
aj
aj
aj
aj
kx
kx
kx
"}
