//MAP CONVERTED BY dmm2tgm.py THIS HEADER COMMENT PREVENTS RECONVERSION, DO NOT REMOVE
"a" = (
/turf/template_noop,
/area/template_noop)
"b" = (
/obj/effect/decal/cleanable/glass,
/obj/effect/decal/cleanable/garbage,
/obj/effect/landmark/cargo_shuttle_crate,
/turf/open/floor/plastic,
/area/shuttle/supply)
"c" = (
/obj/docking_port/mobile/supply{
	dir = 4
	},
/obj/machinery/door/poddoor{
	id = "QMLoaddoor";
	name = "Supply Dock Loading Door"
	},
/obj/machinery/button/door/directional/south{
	id = "QMLoaddoor";
	name = "Loading Doors"
	},
/obj/structure/fans/tiny,
/turf/open/floor/plating,
/area/shuttle/supply)
"d" = (
/obj/effect/landmark/cargo_shuttle_crate,
/obj/machinery/light/small/directional/west,
/turf/open/floor/plastic,
/area/shuttle/supply)
"f" = (
/obj/effect/decal/cleanable/dirt/dust,
/turf/open/floor/plating,
/area/shuttle/supply)
"g" = (
/obj/effect/decal/cleanable/food/salt,
/turf/open/floor/plastic,
/area/shuttle/supply)
"h" = (
/obj/effect/decal/cleanable/glass,
/obj/effect/decal/cleanable/dirt/dust,
/turf/open/floor/plastic,
/area/shuttle/supply)
"i" = (
/obj/structure/shuttle/engine/propulsion/in_wall{
	pixel_y = -17;
	pixel_x = 5
	},
/turf/closed/wall/mineral/titanium,
/area/shuttle/supply)
"j" = (
/obj/effect/decal/cleanable/dirt/dust,
/obj/effect/landmark/cargo_shuttle_crate,
/turf/open/floor/plastic,
/area/shuttle/supply)
"l" = (
/obj/structure/rack,
/obj/effect/decal/cleanable/dirt/dust,
/turf/open/floor/plastic,
/area/shuttle/supply)
"n" = (
/obj/effect/landmark/cargo_shuttle_crate,
/turf/open/floor/plastic,
/area/shuttle/supply)
"o" = (
/obj/structure/chair/comfy/shuttle{
	dir = 1
	},
/obj/machinery/light/small/broken/directional/south,
/turf/open/floor/plastic,
/area/shuttle/supply)
"p" = (
/obj/effect/decal/cleanable/food/salt,
/obj/effect/decal/cleanable/dirt/dust,
/turf/open/floor/plating,
/area/shuttle/supply)
"q" = (
/obj/structure/shuttle/engine/propulsion/in_wall{
	dir = 4;
	pixel_x = 22
	},
/turf/closed/wall/mineral/titanium,
/area/shuttle/supply)
"r" = (
/obj/effect/decal/cleanable/glass,
/obj/effect/decal/cleanable/dirt/dust,
/obj/effect/decal/cleanable/dirt/dust,
/turf/open/floor/plastic,
/area/shuttle/supply)
"t" = (
/obj/machinery/computer{
	name = "defunct computer";
	desc = "One day... one day."
	},
/obj/effect/decal/cleanable/dirt/dust,
/turf/open/floor/plastic,
/area/shuttle/supply)
"u" = (
/obj/effect/spawner/structure/window/reinforced/shuttle,
/obj/structure/shuttle/engine/heater,
/turf/open/floor/plating,
/area/shuttle/supply)
"v" = (
/obj/effect/decal/cleanable/blood/tracks,
/obj/effect/landmark/cargo_shuttle_crate,
/turf/open/floor/plastic,
/area/shuttle/supply)
"x" = (
/obj/effect/decal/cleanable/glass,
/turf/open/floor/plastic,
/area/shuttle/supply)
"z" = (
/turf/open/floor/plating,
/area/shuttle/supply)
"A" = (
/obj/machinery/door/poddoor{
	id = "QMLoaddoor";
	name = "Supply Dock Loading Door"
	},
/obj/effect/decal/cleanable/blood/tracks{
	dir = 4
	},
/obj/structure/fans/tiny,
/turf/open/floor/plating,
/area/shuttle/supply)
"C" = (
/obj/effect/decal/cleanable/blood/tracks,
/obj/effect/decal/cleanable/dirt/dust,
/obj/effect/turf_decal/trimline/yellow/filled/warning,
/turf/open/floor/plastic,
/area/shuttle/supply)
"D" = (
/obj/structure/rack,
/turf/open/floor/plastic,
/area/shuttle/supply)
"E" = (
/obj/structure/shuttle/engine/propulsion/in_wall{
	pixel_y = -17;
	pixel_x = -5
	},
/turf/closed/wall/mineral/titanium,
/area/shuttle/supply)
"G" = (
/obj/effect/decal/cleanable/dirt/dust,
/turf/open/floor/plating/rust,
/area/shuttle/supply)
"H" = (
/obj/structure/rack,
/obj/effect/decal/cleanable/dirt/dust,
/obj/machinery/light/small/directional/east,
/turf/open/floor/plastic,
/area/shuttle/supply)
"I" = (
/obj/structure/shuttle/engine/propulsion/in_wall{
	dir = 8;
	pixel_x = -22
	},
/turf/closed/wall/mineral/titanium,
/area/shuttle/supply)
"K" = (
/obj/effect/decal/cleanable/blood,
/obj/effect/landmark/cargo_shuttle_crate,
/turf/open/floor/plastic,
/area/shuttle/supply)
"L" = (
/obj/effect/spawner/structure/window/reinforced/shuttle,
/turf/open/floor/plating,
/area/shuttle/supply)
"M" = (
/obj/structure/shuttle/engine/propulsion/in_wall{
	pixel_y = -17
	},
/turf/closed/wall/mineral/titanium,
/area/shuttle/supply)
"N" = (
/turf/closed/wall/mineral/titanium,
/area/shuttle/supply)
"P" = (
/obj/machinery/door/bulkhead/mining{
	name = "Freighter Cockpit"
	},
/turf/open/floor/plating/rust,
/area/shuttle/supply)
"Q" = (
/obj/effect/decal/cleanable/oil,
/obj/effect/decal/cleanable/dirt/dust,
/obj/effect/landmark/cargo_shuttle_crate,
/turf/open/floor/plating,
/area/shuttle/supply)
"R" = (
/obj/structure/sign/warning/fire,
/turf/closed/wall/mineral/titanium,
/area/shuttle/supply)
"T" = (
/obj/effect/decal/cleanable/blood/gibs,
/obj/effect/landmark/cargo_shuttle_crate,
/turf/open/floor/plating,
/area/shuttle/supply)
"U" = (
/obj/effect/decal/cleanable/greenglow,
/obj/machinery/light/directional/north,
/turf/open/floor/plastic,
/area/shuttle/supply)
"W" = (
/obj/effect/decal/cleanable/blood/tracks{
	dir = 6
	},
/turf/open/floor/plastic,
/area/shuttle/supply)
"X" = (
/obj/effect/decal/cleanable/oil,
/obj/effect/turf_decal/trimline/yellow/filled/warning,
/turf/open/floor/plastic,
/area/shuttle/supply)
"Y" = (
/obj/structure/rack,
/turf/open/floor/plating/rust,
/area/shuttle/supply)

(1,1,1) = {"
N
N
R
I
A
c
N
N
N
N
a
a
a
a
"}
(2,1,1) = {"
N
T
v
C
W
p
n
d
n
N
R
a
a
a
"}
(3,1,1) = {"
N
K
Q
X
G
x
g
x
f
u
N
i
a
a
"}
(4,1,1) = {"
N
N
N
N
U
n
n
n
j
u
u
M
a
a
"}
(5,1,1) = {"
L
t
o
N
f
x
G
z
b
u
N
E
a
a
"}
(6,1,1) = {"
L
L
r
P
h
l
Y
H
D
N
R
a
a
a
"}
(7,1,1) = {"
a
L
L
q
R
N
N
N
N
N
a
a
a
a
"}
