//MAP CONVERTED BY dmm2tgm.py THIS HEADER COMMENT PREVENTS RECONVERSION, DO NOT REMOVE
"ae" = (
/obj/structure/sign/warning/fire/directional/east,
/turf/open/space/basic,
/area/space)
"bE" = (
/obj/machinery/atmospherics/pipe/smart/manifold4w/orange/hidden,
/turf/open/floor/plating,
/area/shuttle/overmap/aev_p/astrum)
"cZ" = (
/obj/structure/closet/crate/internals,
/obj/item/tank/internals/emergency_oxygen,
/obj/item/tank/internals/emergency_oxygen,
/obj/item/clothing/mask/breath,
/obj/item/clothing/mask/breath,
/obj/machinery/atmospherics/components/unary/vent_pump/on/layer4{
	dir = 4
	},
/obj/effect/decal/cleanable/dirt/dust,
/obj/machinery/airlock_sensor/directional/south,
/obj/effect/mapping_helpers/airlock_controller_helper/sensor/interior,
/turf/open/floor/mineral/plastitanium,
/area/shuttle/overmap/aev_p/astrum)
"dF" = (
/obj/machinery/atmospherics/pipe/smart/manifold4w/orange/hidden,
/obj/machinery/atmospherics/pipe/smart/manifold4w/scrubbers/hidden/layer2,
/obj/structure/cable,
/obj/effect/decal/cleanable/dirt/dust,
/obj/machinery/atmospherics/pipe/smart/manifold4w/supply/hidden/layer4,
/turf/open/floor/mineral/plastitanium,
/area/shuttle/overmap/aev_p/astrum)
"dJ" = (
/obj/machinery/computer/shuttle/pathfinders_shuttle,
/obj/item/paper{
	default_raw_text = "You may wish to upgrade the shuttle's cell ASAP, or get an SMES installed, this damn hunk of junk has less power storage than my house.<br><br>- Intern Engineer";
	name = "Intern's Note"
	},
/turf/open/floor/mineral/plastitanium,
/area/shuttle/overmap/aev_p/astrum)
"eu" = (
/obj/structure/extinguisher_cabinet/directional/south,
/obj/machinery/atmospherics/pipe/smart/manifold4w/supply/hidden/layer4,
/turf/open/floor/mineral/plastitanium,
/area/shuttle/overmap/aev_p/astrum)
"eV" = (
/obj/machinery/light_switch/directional/west,
/obj/machinery/atmospherics/components/unary/airlock_vent/supply/layer4{
	dir = 4
	},
/obj/machinery/airlock_sensor/directional/north,
/obj/effect/mapping_helpers/airlock_controller_helper/pump/simple,
/obj/effect/mapping_helpers/airlock_controller_helper/sensor/chamber,
/turf/open/floor/mineral/plastitanium,
/area/shuttle/overmap/aev_p/astrum)
"fu" = (
/obj/machinery/atmospherics/pipe/smart/manifold4w/orange/hidden,
/obj/machinery/door/airlock/mining/glass,
/obj/machinery/atmospherics/pipe/smart/manifold4w/scrubbers/hidden/layer2,
/obj/machinery/atmospherics/pipe/smart/manifold4w/supply/hidden/layer4,
/turf/open/floor/mineral/plastitanium,
/area/shuttle/overmap/aev_p/astrum)
"fJ" = (
/obj/structure/table,
/obj/item/crowbar/large,
/obj/effect/decal/cleanable/dirt/dust,
/turf/open/floor/plating,
/area/shuttle/overmap/aev_p/astrum)
"gx" = (
/obj/effect/decal/cleanable/dirt/dust,
/obj/effect/decal/cleanable/garbage,
/turf/open/floor/mineral/plastitanium,
/area/shuttle/overmap/aev_p/astrum)
"hc" = (
/obj/machinery/atmospherics/components/unary/engine{
	pixel_y = -8
	},
/turf/closed/wall/mineral/titanium,
/area/shuttle/overmap/aev_p/astrum)
"hq" = (
/obj/machinery/atmospherics/pipe/smart/manifold4w/orange/hidden,
/obj/structure/cable,
/obj/machinery/atmospherics/pipe/smart/manifold4w/scrubbers/hidden/layer2,
/obj/effect/turf_decal/vg_decals/radiation,
/obj/machinery/atmospherics/pipe/smart/manifold4w/supply/hidden/layer4,
/turf/open/floor/mineral/plastitanium,
/area/shuttle/overmap/aev_p/astrum)
"hs" = (
/obj/machinery/atmospherics/pipe/smart/manifold4w/orange/hidden,
/obj/machinery/atmospherics/components/unary/vent_scrubber/on/layer2{
	dir = 1
	},
/turf/open/floor/mineral/plastitanium,
/area/shuttle/overmap/aev_p/astrum)
"hN" = (
/turf/open/floor/plating,
/area/shuttle/overmap/aev_p/astrum)
"iz" = (
/obj/machinery/atmospherics/pipe/smart/manifold4w/orange/hidden,
/obj/effect/decal/cleanable/dirt,
/turf/open/floor/plating,
/area/shuttle/overmap/aev_p/astrum)
"iZ" = (
/obj/machinery/atmospherics/pipe/smart/manifold4w/orange/hidden,
/obj/machinery/atmospherics/pipe/smart/manifold4w/scrubbers/hidden/layer2,
/obj/effect/decal/cleanable/plastic,
/turf/open/floor/plating,
/area/shuttle/overmap/aev_p/astrum)
"jc" = (
/obj/structure/chair/sofa/corp/right,
/turf/open/floor/mineral/plastitanium,
/area/shuttle/overmap/aev_p/astrum)
"jf" = (
/obj/machinery/atmospherics/pipe/smart/manifold4w/scrubbers/hidden/layer2,
/obj/structure/cable,
/obj/effect/decal/cleanable/dirt/dust,
/obj/machinery/atmospherics/pipe/smart/manifold4w/supply/hidden/layer4,
/turf/open/floor/plating,
/area/shuttle/overmap/aev_p/astrum)
"jx" = (
/obj/machinery/atmospherics/pipe/smart/manifold4w/orange/hidden,
/turf/open/floor/iron/recharge_floor,
/area/shuttle/overmap/aev_p/astrum)
"jF" = (
/obj/machinery/suit_storage_unit/hardsuit/mining,
/obj/machinery/light/small/directional/north,
/obj/effect/decal/cleanable/dirt/dust,
/turf/open/floor/mineral/plastitanium,
/area/shuttle/overmap/aev_p/astrum)
"kk" = (
/obj/machinery/atmospherics/components/unary/portables_connector{
	dir = 1
	},
/obj/machinery/portable_atmospherics/canister/carbon_dioxide,
/turf/open/floor/mineral/plastitanium,
/area/shuttle/overmap/aev_p/astrum)
"lp" = (
/obj/structure/cable,
/obj/machinery/recharge_station,
/obj/effect/decal/cleanable/dirt/dust,
/obj/machinery/power/apc/highcap/five_k/directional/north{
	name = "APV-S Astrum APC"
	},
/turf/open/floor/mineral/plastitanium,
/area/shuttle/overmap/aev_p/astrum)
"lK" = (
/obj/machinery/atmospherics/pipe/smart/manifold4w/scrubbers/hidden/layer2,
/obj/structure/cable,
/obj/effect/decal/cleanable/dirt/dust,
/obj/machinery/atmospherics/pipe/smart/manifold4w/supply/hidden/layer4,
/turf/open/floor/mineral/plastitanium,
/area/shuttle/overmap/aev_p/astrum)
"mE" = (
/obj/structure/table/wood,
/obj/item/storage/dice,
/turf/open/floor/plating,
/area/shuttle/overmap/aev_p/astrum)
"nk" = (
/obj/structure/cable,
/obj/machinery/atmospherics/components/unary/vent_pump/on/layer4,
/obj/effect/decal/cleanable/dirt/dust,
/turf/open/floor/mineral/plastitanium,
/area/shuttle/overmap/aev_p/astrum)
"nO" = (
/obj/structure/extinguisher_cabinet/directional/south,
/obj/machinery/atmospherics/components/unary/portables_connector/layer4{
	dir = 1
	},
/obj/machinery/portable_atmospherics/canister/air,
/turf/open/floor/plating,
/area/shuttle/overmap/aev_p/astrum)
"oe" = (
/obj/structure/table/wood,
/obj/item/toy/cards/deck,
/turf/open/floor/mineral/plastitanium,
/area/shuttle/overmap/aev_p/astrum)
"oy" = (
/obj/machinery/door/airlock/command/glass,
/obj/machinery/atmospherics/pipe/smart/manifold4w/scrubbers/hidden/layer2,
/obj/effect/decal/cleanable/dirt/dust,
/obj/effect/mapping_helpers/airlock/access/all/pathfinders/dock,
/obj/machinery/atmospherics/pipe/smart/manifold4w/supply/hidden/layer4,
/turf/open/floor/mineral/plastitanium,
/area/shuttle/overmap/aev_p/astrum)
"oG" = (
/turf/open/space/basic,
/area/space)
"oP" = (
/obj/effect/decal/cleanable/dirt/dust,
/obj/effect/decal/cleanable/dirt/dust,
/obj/machinery/atmospherics/pipe/smart/manifold4w/supply/hidden/layer4,
/turf/open/floor/mineral/plastitanium,
/area/shuttle/overmap/aev_p/astrum)
"pc" = (
/obj/machinery/atmospherics/pipe/smart/manifold4w/scrubbers/hidden/layer2,
/obj/effect/decal/cleanable/dirt/dust,
/obj/effect/decal/cleanable/generic,
/turf/open/floor/mineral/plastitanium,
/area/shuttle/overmap/aev_p/astrum)
"pG" = (
/obj/machinery/atmospherics/components/unary/portables_connector/layer2{
	dir = 1
	},
/obj/machinery/portable_atmospherics/canister,
/obj/machinery/light_switch/directional/west,
/obj/effect/decal/cleanable/dirt/dust,
/turf/open/floor/mineral/plastitanium,
/area/shuttle/overmap/aev_p/astrum)
"re" = (
/obj/machinery/atmospherics/pipe/smart/manifold4w/orange/hidden,
/obj/machinery/atmospherics/components/unary/vent_scrubber/on/layer2{
	dir = 1
	},
/obj/effect/decal/cleanable/plastic,
/turf/open/floor/mineral/plastitanium,
/area/shuttle/overmap/aev_p/astrum)
"rE" = (
/obj/structure/closet/crate,
/obj/effect/spawner/random/maintenance,
/obj/item/crowbar/large,
/turf/open/floor/mineral/plastitanium,
/area/shuttle/overmap/aev_p/astrum)
"rY" = (
/obj/structure/closet/crate,
/obj/effect/spawner/random/maintenance/two,
/turf/open/floor/mineral/plastitanium,
/area/shuttle/overmap/aev_p/astrum)
"sN" = (
/obj/machinery/atmospherics/pipe/smart/manifold4w/orange/hidden,
/obj/structure/closet/firecloset/full,
/obj/machinery/atmospherics/pipe/smart/manifold4w/scrubbers/hidden/layer2,
/obj/effect/decal/cleanable/dirt,
/turf/open/floor/mineral/plastitanium,
/area/shuttle/overmap/aev_p/astrum)
"tb" = (
/obj/structure/extinguisher_cabinet/directional/south,
/obj/effect/decal/cleanable/dirt,
/obj/effect/decal/cleanable/insectguts,
/turf/open/floor/mineral/plastitanium,
/area/shuttle/overmap/aev_p/astrum)
"tV" = (
/obj/effect/decal/cleanable/plastic,
/obj/effect/decal/cleanable/dirt/dust,
/turf/open/floor/mineral/plastitanium,
/area/shuttle/overmap/aev_p/astrum)
"uo" = (
/obj/machinery/telecomms/relay/preset/pathfinders,
/turf/open/floor/circuit,
/area/shuttle/overmap/aev_p/astrum)
"uQ" = (
/obj/machinery/mech_bay_recharge_port{
	dir = 2
	},
/turf/open/floor/circuit/green,
/area/shuttle/overmap/aev_p/astrum)
"vh" = (
/obj/structure/sign/warning/fire/directional/west,
/turf/open/space/basic,
/area/space)
"vR" = (
/obj/structure/ore_box,
/turf/open/floor/plating,
/area/shuttle/overmap/aev_p/astrum)
"wh" = (
/obj/machinery/atmospherics/pipe/smart/manifold4w/orange/hidden,
/obj/machinery/atmospherics/pipe/smart/manifold4w/scrubbers/hidden/layer2,
/turf/open/floor/mineral/plastitanium,
/area/shuttle/overmap/aev_p/astrum)
"wT" = (
/obj/machinery/light/small/directional/east,
/obj/machinery/airlock_controller/autoset/directional/north,
/turf/open/floor/mineral/plastitanium,
/area/shuttle/overmap/aev_p/astrum)
"xz" = (
/obj/structure/chair/comfy/shuttle{
	dir = 1
	},
/obj/effect/decal/cleanable/dirt/dust,
/turf/open/floor/mineral/plastitanium,
/area/shuttle/overmap/aev_p/astrum)
"xO" = (
/obj/machinery/atmospherics/pipe/smart/manifold4w/orange/hidden,
/obj/machinery/atmospherics/pipe/smart/manifold4w/scrubbers/hidden/layer2,
/obj/machinery/atmospherics/pipe/smart/manifold4w/supply/hidden/layer4,
/turf/open/floor/mineral/plastitanium,
/area/shuttle/overmap/aev_p/astrum)
"xU" = (
/obj/machinery/atmospherics/components/unary/vent_pump/on/layer4,
/turf/open/floor/mineral/plastitanium,
/area/shuttle/overmap/aev_p/astrum)
"xZ" = (
/obj/structure/table,
/obj/item/crowbar/large,
/turf/open/floor/mineral/plastitanium,
/area/shuttle/overmap/aev_p/astrum)
"yH" = (
/obj/machinery/light_switch/directional/east,
/obj/effect/decal/cleanable/dirt,
/turf/open/floor/plating,
/area/shuttle/overmap/aev_p/astrum)
"zL" = (
/obj/machinery/atmospherics/pipe/smart/manifold4w/scrubbers/hidden/layer2,
/obj/effect/decal/cleanable/dirt/dust,
/obj/effect/decal/cleanable/oil,
/obj/machinery/atmospherics/pipe/smart/manifold4w/supply/hidden/layer4,
/turf/open/floor/mineral/plastitanium,
/area/shuttle/overmap/aev_p/astrum)
"zY" = (
/obj/effect/decal/cleanable/robot_debris,
/obj/effect/decal/cleanable/dirt/dust,
/turf/open/floor/mineral/plastitanium,
/area/shuttle/overmap/aev_p/astrum)
"Ap" = (
/obj/machinery/atmospherics/pipe/smart/manifold4w/scrubbers/hidden/layer2,
/obj/machinery/atmospherics/pipe/smart/manifold4w/supply/hidden/layer4,
/turf/open/floor/mineral/plastitanium,
/area/shuttle/overmap/aev_p/astrum)
"As" = (
/obj/machinery/atmospherics/pipe/smart/manifold4w/scrubbers/hidden/layer2,
/obj/structure/cable,
/obj/machinery/atmospherics/pipe/smart/manifold4w/supply/hidden/layer4,
/turf/open/floor/mineral/plastitanium,
/area/shuttle/overmap/aev_p/astrum)
"At" = (
/obj/machinery/light/directional/west,
/obj/structure/table,
/obj/machinery/recharger,
/turf/open/floor/mineral/plastitanium,
/area/shuttle/overmap/aev_p/astrum)
"Az" = (
/obj/machinery/atmospherics/pipe/smart/manifold4w/scrubbers/hidden/layer2,
/obj/effect/decal/cleanable/dirt/dust,
/obj/machinery/atmospherics/pipe/smart/manifold4w/supply/hidden/layer4,
/turf/open/floor/mineral/plastitanium,
/area/shuttle/overmap/aev_p/astrum)
"BB" = (
/obj/machinery/atmospherics/pipe/smart/manifold4w/orange/hidden,
/obj/structure/cable,
/obj/machinery/atmospherics/pipe/smart/manifold4w/scrubbers/hidden/layer2,
/obj/machinery/atmospherics/pipe/smart/manifold4w/supply/hidden/layer4,
/turf/open/floor/plating,
/area/shuttle/overmap/aev_p/astrum)
"DU" = (
/obj/structure/lattice,
/turf/open/space/basic,
/area/shuttle/overmap/aev_p/astrum)
"Et" = (
/obj/effect/decal/cleanable/dirt,
/turf/open/floor/plating,
/area/shuttle/overmap/aev_p/astrum)
"EH" = (
/obj/machinery/light/directional/west,
/obj/effect/decal/cleanable/dirt,
/turf/open/floor/plating,
/area/shuttle/overmap/aev_p/astrum)
"Gg" = (
/obj/machinery/button/door/directional/south{
	id = "astrum_oh_shit_button";
	name = "Window Shutters"
	},
/obj/effect/decal/cleanable/dirt/dust,
/turf/open/floor/mineral/plastitanium,
/area/shuttle/overmap/aev_p/astrum)
"GJ" = (
/obj/structure/chair/office{
	dir = 4
	},
/turf/open/floor/plating,
/area/shuttle/overmap/aev_p/astrum)
"GP" = (
/obj/machinery/atmospherics/pipe/smart/manifold4w/scrubbers/hidden/layer2,
/turf/open/floor/mineral/plastitanium,
/area/shuttle/overmap/aev_p/astrum)
"Hu" = (
/obj/machinery/atmospherics/pipe/smart/manifold4w/scrubbers/hidden/layer2,
/obj/machinery/light/directional/east,
/obj/machinery/atmospherics/pipe/smart/manifold4w/supply/hidden/layer4,
/turf/open/floor/plating,
/area/shuttle/overmap/aev_p/astrum)
"Hy" = (
/obj/effect/decal/cleanable/dirt,
/turf/open/floor/mineral/plastitanium,
/area/shuttle/overmap/aev_p/astrum)
"HE" = (
/obj/structure/marker_beacon/burgundy,
/obj/structure/lattice/catwalk,
/turf/open/space/basic,
/area/shuttle/overmap/aev_p/astrum)
"IM" = (
/obj/machinery/airalarm/directional/east,
/obj/effect/decal/cleanable/garbage,
/turf/open/floor/mineral/plastitanium,
/area/shuttle/overmap/aev_p/astrum)
"IO" = (
/obj/machinery/atmospherics/pipe/smart/manifold4w/orange/hidden,
/obj/effect/decal/cleanable/dirt/dust,
/turf/open/floor/plating,
/area/shuttle/overmap/aev_p/astrum)
"Jm" = (
/obj/machinery/atmospherics/pipe/smart/manifold4w/orange/hidden,
/obj/structure/cable,
/obj/machinery/atmospherics/pipe/smart/manifold4w/scrubbers/hidden/layer2,
/obj/machinery/atmospherics/pipe/smart/manifold4w/supply/hidden/layer4,
/turf/open/floor/mineral/plastitanium,
/area/shuttle/overmap/aev_p/astrum)
"Jy" = (
/obj/machinery/atmospherics/pipe/smart/manifold4w/scrubbers/hidden/layer2,
/obj/structure/cable,
/obj/machinery/door/airlock/public,
/obj/machinery/atmospherics/pipe/smart/manifold4w/supply/hidden/layer4,
/turf/open/floor/mineral/plastitanium,
/area/shuttle/overmap/aev_p/astrum)
"Kj" = (
/turf/closed/wall/mineral/titanium,
/area/shuttle/overmap/aev_p/astrum)
"Ku" = (
/obj/machinery/airalarm/directional/east,
/obj/machinery/atmospherics/components/unary/vent_pump/on/layer4,
/obj/effect/decal/cleanable/dirt/dust,
/turf/open/floor/mineral/plastitanium,
/area/shuttle/overmap/aev_p/astrum)
"KN" = (
/obj/machinery/atmospherics/pipe/smart/manifold4w/orange/hidden,
/obj/machinery/light/small/directional/west,
/obj/effect/decal/cleanable/dirt/dust,
/turf/open/floor/plating,
/area/shuttle/overmap/aev_p/astrum)
"KY" = (
/turf/open/floor/mineral/plastitanium,
/area/shuttle/overmap/aev_p/astrum)
"Ld" = (
/obj/structure/lattice/catwalk,
/obj/structure/marker_beacon/burgundy,
/turf/open/space/basic,
/area/shuttle/overmap/aev_p/astrum)
"LF" = (
/obj/structure/closet/secure_closet/miner,
/turf/open/floor/mineral/plastitanium,
/area/shuttle/overmap/aev_p/astrum)
"LY" = (
/obj/effect/turf_decal/vg_decals/atmos/air,
/obj/machinery/atmospherics/pipe/smart/manifold4w/scrubbers/hidden/layer2,
/obj/effect/decal/cleanable/dirt/dust,
/obj/machinery/atmospherics/pipe/smart/manifold4w/supply/hidden/layer4,
/turf/open/floor/mineral/plastitanium,
/area/shuttle/overmap/aev_p/astrum)
"Mf" = (
/obj/machinery/computer/mech_bay_power_console{
	dir = 8
	},
/obj/machinery/light/directional/east,
/turf/open/floor/circuit/green,
/area/shuttle/overmap/aev_p/astrum)
"Mo" = (
/obj/machinery/atmospherics/pipe/smart/manifold4w/supply/hidden/layer4,
/turf/open/floor/mineral/plastitanium,
/area/shuttle/overmap/aev_p/astrum)
"MP" = (
/obj/structure/table/reinforced,
/obj/machinery/airalarm/directional/west,
/obj/item/crowbar/large,
/obj/effect/decal/cleanable/dirt/dust,
/turf/open/floor/mineral/plastitanium,
/area/shuttle/overmap/aev_p/astrum)
"Nm" = (
/obj/machinery/light/directional/east,
/obj/structure/table,
/obj/machinery/recharger,
/obj/effect/decal/cleanable/dirt/dust,
/turf/open/floor/mineral/plastitanium,
/area/shuttle/overmap/aev_p/astrum)
"OI" = (
/obj/machinery/atmospherics/components/unary/vent_pump/on/layer4{
	dir = 8
	},
/obj/effect/decal/cleanable/dirt/dust,
/turf/open/floor/mineral/plastitanium,
/area/shuttle/overmap/aev_p/astrum)
"OO" = (
/obj/structure/ore_box,
/turf/open/floor/mineral/plastitanium,
/area/shuttle/overmap/aev_p/astrum)
"OP" = (
/obj/structure/table/reinforced,
/obj/item/storage/toolbox/mechanical,
/turf/open/floor/mineral/plastitanium,
/area/shuttle/overmap/aev_p/astrum)
"PP" = (
/obj/structure/cable,
/obj/effect/decal/cleanable/robot_debris,
/obj/machinery/atmospherics/pipe/smart/manifold4w/supply/hidden/layer4,
/turf/open/floor/mineral/plastitanium,
/area/shuttle/overmap/aev_p/astrum)
"RS" = (
/obj/structure/chair/office{
	dir = 4
	},
/turf/open/floor/mineral/plastitanium,
/area/shuttle/overmap/aev_p/astrum)
"RW" = (
/obj/machinery/airalarm/directional/south,
/obj/effect/decal/cleanable/oil,
/obj/machinery/atmospherics/pipe/smart/manifold4w/supply/hidden/layer4,
/turf/open/floor/mineral/plastitanium,
/area/shuttle/overmap/aev_p/astrum)
"Sh" = (
/obj/machinery/atmospherics/pipe/smart/manifold4w/scrubbers/hidden/layer2,
/obj/structure/cable,
/obj/machinery/door/airlock/external/glass,
/obj/machinery/atmospherics/pipe/smart/manifold4w/supply/hidden/layer4,
/obj/effect/mapping_helpers/airlock_controller_helper/airlock/interior,
/turf/open/floor/mineral/plastitanium,
/area/shuttle/overmap/aev_p/astrum)
"Sq" = (
/obj/structure/chair/sofa/corp/left{
	dir = 8
	},
/obj/effect/decal/cleanable/dirt/dust,
/turf/open/floor/mineral/plastitanium,
/area/shuttle/overmap/aev_p/astrum)
"Tp" = (
/obj/structure/table,
/obj/item/crowbar/large,
/obj/machinery/atmospherics/components/unary/vent_scrubber/on/layer2{
	dir = 8
	},
/obj/effect/decal/cleanable/dirt/dust,
/turf/open/floor/mineral/plastitanium,
/area/shuttle/overmap/aev_p/astrum)
"Tr" = (
/obj/structure/lattice/catwalk,
/obj/structure/marker_beacon/burgundy,
/obj/machinery/airlock_sensor/directional/east,
/obj/effect/mapping_helpers/airlock_controller_helper/sensor/exterior,
/turf/open/space/basic,
/area/shuttle/overmap/aev_p/astrum)
"Tu" = (
/obj/effect/spawner/random/structure/crate_loot,
/turf/open/floor/mineral/plastitanium,
/area/shuttle/overmap/aev_p/astrum)
"UN" = (
/obj/structure/extinguisher_cabinet/directional/south,
/obj/effect/decal/cleanable/dirt/dust,
/turf/open/floor/plating,
/area/shuttle/overmap/aev_p/astrum)
"VS" = (
/obj/structure/table/wood,
/obj/item/paper_bin,
/obj/item/pen,
/turf/open/floor/mineral/plastitanium,
/area/shuttle/overmap/aev_p/astrum)
"VT" = (
/obj/structure/chair/sofa/corp/corner,
/obj/effect/decal/cleanable/dirt/dust,
/turf/open/floor/mineral/plastitanium,
/area/shuttle/overmap/aev_p/astrum)
"Wk" = (
/obj/machinery/modular_computer/console/preset/id,
/turf/open/floor/mineral/plastitanium,
/area/shuttle/overmap/aev_p/astrum)
"Wo" = (
/obj/machinery/light_switch/directional/south,
/obj/machinery/atmospherics/components/unary/vent_scrubber/on/layer2{
	dir = 1
	},
/obj/effect/decal/cleanable/dirt/dust,
/turf/open/floor/mineral/plastitanium,
/area/shuttle/overmap/aev_p/astrum)
"Wq" = (
/obj/machinery/atmospherics/pipe/smart/manifold4w/orange/hidden,
/obj/effect/turf_decal/vg_decals/atmos/carbon_dioxide,
/obj/effect/decal/cleanable/dirt/dust,
/turf/open/floor/mineral/plastitanium,
/area/shuttle/overmap/aev_p/astrum)
"WE" = (
/obj/structure/sign/warning/fire/directional/north,
/turf/open/space/basic,
/area/space)
"Xj" = (
/obj/machinery/light_switch/directional/west,
/obj/machinery/atmospherics/components/unary/vent_scrubber/on/layer2,
/obj/effect/decal/cleanable/dirt/dust,
/turf/open/floor/mineral/plastitanium,
/area/shuttle/overmap/aev_p/astrum)
"Yf" = (
/obj/machinery/atmospherics/pipe/smart/manifold4w/scrubbers/hidden/layer2,
/obj/machinery/atmospherics/pipe/smart/manifold4w/supply/hidden/layer4,
/turf/open/floor/plating,
/area/shuttle/overmap/aev_p/astrum)
"Yw" = (
/obj/machinery/autolathe,
/turf/open/floor/plating,
/area/shuttle/overmap/aev_p/astrum)
"Yy" = (
/obj/machinery/atmospherics/pipe/smart/manifold4w/orange/hidden,
/obj/structure/cable,
/obj/machinery/door/airlock/engineering/glass,
/obj/machinery/atmospherics/pipe/smart/manifold4w/scrubbers/hidden/layer2,
/obj/effect/mapping_helpers/airlock/access/all/pathfinders/dock,
/obj/machinery/atmospherics/pipe/smart/manifold4w/supply/hidden/layer4,
/turf/open/floor/mineral/plastitanium,
/area/shuttle/overmap/aev_p/astrum)
"YS" = (
/obj/effect/decal/cleanable/dirt/dust,
/turf/open/floor/plating,
/area/shuttle/overmap/aev_p/astrum)
"YT" = (
/obj/effect/spawner/structure/window/reinforced/shuttle,
/obj/machinery/door/poddoor/shutters{
	id = "astrum_oh_shit_button";
	name = "AEV Astrum Shutter"
	},
/turf/open/floor/plating,
/area/shuttle/overmap/aev_p/astrum)
"Zc" = (
/obj/machinery/atmospherics/pipe/smart/manifold4w/orange/hidden,
/obj/machinery/light/small/directional/east,
/turf/open/floor/plating,
/area/shuttle/overmap/aev_p/astrum)
"Zg" = (
/obj/structure/table/wood,
/obj/effect/decal/cleanable/dirt/dust,
/turf/open/floor/mineral/plastitanium,
/area/shuttle/overmap/aev_p/astrum)
"ZJ" = (
/obj/machinery/suit_storage_unit/hardsuit/mining,
/obj/machinery/airalarm/directional/north,
/turf/open/floor/mineral/plastitanium,
/area/shuttle/overmap/aev_p/astrum)
"ZZ" = (
/obj/structure/cable,
/obj/structure/fans/tiny,
/obj/docking_port/mobile{
	shuttle_id = "pathfinders_astrum";
	name = "APV-S Astrum";
	port_direction = 2
	},
/obj/machinery/atmospherics/components/binary/pump/off/supply/visible/layer4{
	dir = 1
	},
/obj/machinery/atmospherics/components/binary/pump/off/scrubbers/visible/layer2,
/obj/machinery/door/airlock/external/glass,
/obj/effect/mapping_helpers/airlock_controller_helper/airlock/exterior,
/turf/open/floor/mineral/plastitanium,
/area/shuttle/overmap/aev_p/astrum)

(1,1,1) = {"
oG
oG
oG
oG
ae
oG
ae
oG
oG
oG
oG
oG
oG
oG
oG
oG
oG
oG
oG
"}
(2,1,1) = {"
oG
oG
YT
YT
Kj
Kj
Kj
Kj
Kj
Kj
Kj
YT
YT
Kj
Kj
Kj
Kj
Kj
WE
"}
(3,1,1) = {"
oG
YT
YT
fJ
At
YS
Kj
rY
EH
Tu
sN
wh
hs
bE
Zc
iz
iz
hc
oG
"}
(4,1,1) = {"
oG
YT
dJ
xz
GP
Wo
Kj
rE
xU
Mo
xO
hN
tb
Kj
Kj
Kj
Kj
Kj
WE
"}
(5,1,1) = {"
oG
YT
Wk
hN
pc
Gg
Kj
vR
KY
Et
xO
Hy
LF
Kj
oG
oG
oG
oG
oG
"}
(6,1,1) = {"
oG
YT
YT
Ku
Ap
UN
Kj
OO
Hy
IM
xO
yH
Kj
Kj
YT
Kj
Kj
YT
Tr
"}
(7,1,1) = {"
oG
oG
YT
Kj
oy
YT
Kj
Kj
YT
Kj
fu
Kj
Kj
ZJ
cZ
Kj
eV
YT
Kj
"}
(8,1,1) = {"
oG
oG
YT
Xj
zL
Yf
Ap
Az
Ap
Hu
dF
lK
Jy
jf
As
Sh
As
As
ZZ
"}
(9,1,1) = {"
oG
oG
YT
GJ
RS
oP
Kj
Kj
YT
Kj
Yy
Kj
Kj
jF
Tp
Kj
wT
YT
Kj
"}
(10,1,1) = {"
oG
YT
YT
oe
Zg
eu
Kj
Yw
OP
MP
hq
pG
Kj
Kj
YT
Kj
Kj
YT
Ld
"}
(11,1,1) = {"
oG
YT
jc
VS
mE
RW
Kj
zY
hN
tV
BB
Wq
kk
Kj
oG
oG
oG
oG
oG
"}
(12,1,1) = {"
oG
YT
VT
Sq
gx
OI
Kj
lp
nk
PP
Jm
LY
nO
Kj
Kj
Kj
Kj
Kj
WE
"}
(13,1,1) = {"
oG
YT
YT
xZ
Nm
YS
Kj
uo
Mf
uQ
jx
iZ
re
bE
KN
bE
IO
hc
oG
"}
(14,1,1) = {"
HE
DU
Kj
Kj
Kj
Kj
Kj
Kj
Kj
Kj
Kj
YT
YT
Kj
Kj
Kj
Kj
Kj
WE
"}
(15,1,1) = {"
oG
oG
oG
oG
vh
oG
vh
oG
oG
oG
oG
oG
oG
oG
oG
oG
oG
oG
oG
"}
