//MAP CONVERTED BY dmm2tgm.py THIS HEADER COMMENT PREVENTS RECONVERSION, DO NOT REMOVE
"ag" = (
/obj/machinery/door/bulkhead/engineering{
	name = "Hermes Engineering"
	},
/obj/effect/turf_decal/stripes/orange/box,
/obj/machinery/atmospherics/pipe/smart/manifold4w/scrubbers/visible/layer2,
/obj/machinery/atmospherics/pipe/smart/manifold4w/supply/visible/layer4,
/obj/effect/mapping_helpers/bulkhead/access/all/pathfinders/dock,
/obj/machinery/door/firehead,
/obj/structure/cable,
/turf/open/floor/mineral/plastitanium,
/area/shuttle/overmap/aev_p/hermes)
"aC" = (
/obj/structure/lattice,
/turf/template_noop,
/area/shuttle/overmap/aev_p/hermes)
"aF" = (
/obj/effect/turf_decal/stripes/line{
	dir = 10
	},
/obj/machinery/atmospherics/components/unary/vent_scrubber/on/layer2{
	dir = 8
	},
/obj/machinery/atmospherics/pipe/smart/manifold4w/supply/visible/layer4,
/turf/open/floor/mineral/plastitanium,
/area/shuttle/overmap/aev_p/hermes)
"bu" = (
/obj/structure/extinguisher_cabinet/directional/north,
/obj/machinery/atmospherics/pipe/smart/manifold4w/scrubbers/visible/layer2,
/obj/machinery/atmospherics/pipe/smart/manifold4w/supply/visible/layer4,
/turf/open/floor/mineral/plastitanium,
/area/shuttle/overmap/aev_p/hermes)
"cn" = (
/obj/effect/turf_decal/stripes/orange/corner,
/obj/machinery/atmospherics/components/unary/portables_connector/layer4{
	dir = 4
	},
/obj/machinery/portable_atmospherics/canister/air,
/obj/effect/turf_decal/box/orange,
/turf/open/floor/mineral/plastitanium,
/area/shuttle/overmap/aev_p/hermes)
"cN" = (
/obj/structure/closet/crate,
/obj/effect/spawner/random/maintenance,
/obj/item/crowbar/large,
/obj/effect/turf_decal/tile/neutral/fourcorners,
/obj/effect/turf_decal/delivery,
/obj/machinery/button/door/directional/east{
	id = "Hermes blastdoor";
	name = "Blast door Toggle"
	},
/turf/open/floor/iron/dark/textured,
/area/shuttle/overmap/aev_p/hermes)
"cO" = (
/obj/effect/turf_decal/stripes/orange/line,
/obj/machinery/atmospherics/pipe/smart/manifold4w/orange/visible,
/obj/machinery/autolathe,
/turf/open/floor/mineral/plastitanium,
/area/shuttle/overmap/aev_p/hermes)
"cQ" = (
/obj/effect/turf_decal/tile/neutral/fourcorners,
/obj/effect/turf_decal/bot,
/obj/structure/table,
/obj/machinery/recharger,
/turf/open/floor/iron/dark/textured,
/area/shuttle/overmap/aev_p/hermes)
"ey" = (
/obj/machinery/door/bulkhead/external{
	dir = 4
	},
/obj/effect/mapping_helpers/bulkhead/magic_cyclelink_helper{
	dir = 4
	},
/obj/structure/fans/tiny,
/obj/docking_port/mobile{
	dir = 4;
	name = "APV-S Hermes";
	shuttle_id = "pathfinders_hermes"
	},
/obj/effect/turf_decal/stripes/orange/box,
/obj/machinery/atmospherics/pipe/smart/manifold4w/scrubbers/visible/layer2,
/obj/machinery/atmospherics/pipe/smart/manifold4w/supply/visible/layer4,
/obj/effect/mapping_helpers/bulkhead/access/all/pathfinders/dock,
/obj/machinery/door/firehead{
	dir = 8
	},
/obj/structure/cable,
/turf/open/floor/mineral/plastitanium,
/area/shuttle/overmap/aev_p/hermes)
"eL" = (
/obj/machinery/computer/shuttle/pathfinders_shuttle,
/obj/effect/turf_decal/tile/neutral/fourcorners,
/obj/effect/turf_decal/bot,
/turf/open/floor/iron/dark/textured,
/area/shuttle/overmap/aev_p/hermes)
"gO" = (
/obj/machinery/firealarm/directional/north,
/obj/effect/turf_decal/stripes/orange/corner{
	dir = 4
	},
/obj/machinery/atmospherics/pipe/smart/manifold4w/scrubbers/visible/layer2,
/obj/machinery/atmospherics/pipe/smart/manifold4w/supply/visible/layer4,
/turf/open/floor/mineral/plastitanium,
/area/shuttle/overmap/aev_p/hermes)
"jM" = (
/obj/effect/turf_decal/stripes/line{
	dir = 6
	},
/obj/machinery/light/directional/south,
/obj/machinery/atmospherics/components/unary/vent_pump/on/layer4{
	dir = 8
	},
/turf/open/floor/mineral/plastitanium,
/area/shuttle/overmap/aev_p/hermes)
"kf" = (
/obj/effect/turf_decal/stripes/line{
	dir = 8
	},
/obj/machinery/atmospherics/pipe/smart/manifold4w/supply/visible/layer4,
/turf/open/floor/mineral/plastitanium,
/area/shuttle/overmap/aev_p/hermes)
"kI" = (
/obj/structure/fans/tiny,
/obj/effect/turf_decal/stripes/line,
/obj/effect/turf_decal/stripes/line{
	dir = 1
	},
/obj/machinery/door/poddoor{
	id = "Hermes blastdoor"
	},
/turf/open/floor/plating,
/area/shuttle/overmap/aev_p/hermes)
"mb" = (
/obj/structure/lattice/catwalk,
/obj/machinery/button/door/directional/east{
	id = "Hermes blastdoor";
	name = "Blast door Toggle"
	},
/turf/template_noop,
/area/shuttle/overmap/aev_p/hermes)
"mg" = (
/obj/effect/turf_decal/stripes/orange/line,
/obj/machinery/atmospherics/pipe/smart/manifold4w/orange/visible,
/obj/structure/closet/secure_closet/miner,
/obj/machinery/atmospherics/pipe/smart/manifold4w/supply/visible/layer4,
/turf/open/floor/mineral/plastitanium,
/area/shuttle/overmap/aev_p/hermes)
"nj" = (
/turf/closed/wall/mineral/titanium,
/area/shuttle/overmap/aev_p/hermes)
"ns" = (
/obj/effect/turf_decal/stripes/line{
	dir = 9
	},
/obj/structure/chair/comfy/shuttle{
	dir = 1
	},
/obj/machinery/firealarm/directional/west,
/turf/open/floor/mineral/plastitanium,
/area/shuttle/overmap/aev_p/hermes)
"nH" = (
/turf/template_noop,
/area/template_noop)
"oc" = (
/obj/machinery/telecomms/relay/preset/pathfinders,
/turf/open/floor/mineral/plastitanium,
/area/shuttle/overmap/aev_p/hermes)
"oj" = (
/obj/structure/chair/comfy/shuttle{
	dir = 4
	},
/obj/effect/turf_decal/tile/neutral/fourcorners,
/obj/effect/turf_decal/bot,
/turf/open/floor/iron/dark/textured,
/area/shuttle/overmap/aev_p/hermes)
"oF" = (
/obj/effect/turf_decal/tile/neutral/fourcorners,
/obj/effect/turf_decal/bot,
/obj/machinery/modular_computer/console/preset/id,
/turf/open/floor/iron/dark/textured,
/area/shuttle/overmap/aev_p/hermes)
"ph" = (
/obj/effect/turf_decal/stripes/line{
	dir = 9
	},
/turf/open/floor/mineral/plastitanium,
/area/shuttle/overmap/aev_p/hermes)
"pu" = (
/obj/effect/turf_decal/tile/neutral/fourcorners,
/obj/effect/turf_decal/bot,
/obj/structure/table,
/obj/machinery/button/door/directional{
	pixel_y = 6;
	pixel_x = 6;
	id = "hermes shutter";
	name = "Hermes Shutter Toggle"
	},
/obj/machinery/button/door/directional{
	pixel_y = 6;
	pixel_x = -5;
	id = "Hermes blastdoor";
	name = "Blast door Toggle"
	},
/turf/open/floor/iron/dark/textured,
/area/shuttle/overmap/aev_p/hermes)
"qL" = (
/obj/effect/turf_decal/tile/neutral/fourcorners,
/obj/effect/turf_decal/delivery,
/obj/effect/spawner/random/structure/crate_loot,
/obj/machinery/light/directional/east,
/turf/open/floor/iron/dark/textured,
/area/shuttle/overmap/aev_p/hermes)
"rm" = (
/obj/effect/spawner/structure/window/reinforced/shuttle,
/obj/machinery/door/poddoor/shutters{
	id = "hermes shutter";
	name = "AEV Hermes Shutter"
	},
/turf/open/floor/plating,
/area/shuttle/overmap/aev_p/hermes)
"sl" = (
/obj/effect/turf_decal/stripes/corner{
	dir = 4
	},
/obj/machinery/atmospherics/pipe/smart/manifold4w/scrubbers/visible/layer2,
/turf/open/floor/mineral/plastitanium,
/area/shuttle/overmap/aev_p/hermes)
"tn" = (
/obj/effect/turf_decal/tile/neutral/fourcorners,
/obj/effect/turf_decal/bot,
/obj/machinery/suit_storage_unit/hardsuit/mining,
/obj/item/radio/intercom/directional/east,
/turf/open/floor/iron/dark/textured,
/area/shuttle/overmap/aev_p/hermes)
"uv" = (
/obj/machinery/atmospherics/components/unary/portables_connector/layer2{
	dir = 4
	},
/obj/machinery/portable_atmospherics/canister,
/obj/effect/turf_decal/box/orange,
/turf/open/floor/mineral/plastitanium,
/area/shuttle/overmap/aev_p/hermes)
"vr" = (
/obj/effect/turf_decal/stripes/line{
	dir = 4
	},
/obj/machinery/atmospherics/pipe/smart/manifold4w/scrubbers/visible/layer2,
/turf/open/floor/mineral/plastitanium,
/area/shuttle/overmap/aev_p/hermes)
"vW" = (
/obj/structure/marker_beacon/burgundy,
/turf/closed/wall/mineral/titanium,
/area/shuttle/overmap/aev_p/hermes)
"xx" = (
/obj/effect/turf_decal/stripes/orange/line{
	dir = 1
	},
/obj/machinery/atmospherics/pipe/smart/manifold4w/scrubbers/visible/layer2,
/obj/machinery/atmospherics/pipe/smart/manifold4w/supply/visible/layer4,
/obj/structure/cable,
/turf/open/floor/mineral/plastitanium,
/area/shuttle/overmap/aev_p/hermes)
"zh" = (
/obj/effect/turf_decal/stripes/orange/corner{
	dir = 8
	},
/obj/machinery/atmospherics/components/unary/portables_connector{
	dir = 8
	},
/obj/machinery/portable_atmospherics/canister/carbon_dioxide,
/obj/effect/turf_decal/box/orange,
/turf/open/floor/mineral/plastitanium,
/area/shuttle/overmap/aev_p/hermes)
"Af" = (
/obj/effect/turf_decal/stripes/line{
	dir = 4
	},
/obj/machinery/atmospherics/components/unary/vent_scrubber/on/layer2,
/turf/open/floor/mineral/plastitanium,
/area/shuttle/overmap/aev_p/hermes)
"Ai" = (
/obj/effect/turf_decal/stripes/orange/corner{
	dir = 8
	},
/obj/machinery/atmospherics/pipe/smart/manifold4w/orange/visible,
/obj/machinery/recharge_station,
/turf/open/floor/mineral/plastitanium,
/area/shuttle/overmap/aev_p/hermes)
"Au" = (
/obj/machinery/door/bulkhead/external{
	dir = 4
	},
/obj/effect/mapping_helpers/bulkhead/magic_cyclelink_helper{
	dir = 8
	},
/obj/effect/turf_decal/stripes/orange/box,
/obj/machinery/atmospherics/pipe/smart/manifold4w/scrubbers/visible/layer2,
/obj/machinery/atmospherics/pipe/smart/manifold4w/supply/visible/layer4,
/obj/effect/mapping_helpers/bulkhead/access/all/pathfinders/dock,
/obj/machinery/door/firehead{
	dir = 8
	},
/obj/structure/cable,
/turf/open/floor/mineral/plastitanium,
/area/shuttle/overmap/aev_p/hermes)
"AG" = (
/obj/effect/turf_decal/stripes/orange/corner,
/obj/machinery/atmospherics/pipe/smart/manifold4w/orange/visible,
/obj/structure/table,
/obj/machinery/recharger,
/turf/open/floor/mineral/plastitanium,
/area/shuttle/overmap/aev_p/hermes)
"Bm" = (
/obj/machinery/door/bulkhead/command{
	dir = 4;
	name = "Hermes Bridge"
	},
/obj/effect/turf_decal/stripes/box,
/obj/machinery/atmospherics/pipe/smart/manifold4w/scrubbers/visible/layer2,
/obj/machinery/atmospherics/pipe/smart/manifold4w/supply/visible/layer4,
/obj/effect/mapping_helpers/bulkhead/access/all/pathfinders/dock,
/obj/machinery/door/firehead{
	dir = 8
	},
/turf/open/floor/mineral/plastitanium,
/area/shuttle/overmap/aev_p/hermes)
"BD" = (
/obj/structure/lattice,
/turf/template_noop,
/area/template_noop)
"BF" = (
/obj/effect/turf_decal/stripes/orange/line,
/obj/machinery/atmospherics/pipe/smart/manifold4w/orange/visible,
/obj/effect/turf_decal/vg_decals/atmos/carbon_dioxide,
/obj/machinery/meter,
/obj/structure/cable,
/obj/machinery/power/port_gen/pacman,
/turf/open/floor/mineral/plastitanium,
/area/shuttle/overmap/aev_p/hermes)
"Cb" = (
/obj/machinery/light/red/directional/north,
/obj/machinery/atmospherics/pipe/smart/manifold4w/scrubbers/visible/layer2,
/obj/machinery/atmospherics/pipe/smart/manifold4w/supply/visible/layer4,
/turf/open/floor/mineral/plastitanium,
/area/shuttle/overmap/aev_p/hermes)
"CO" = (
/obj/machinery/light/red/directional/north,
/obj/machinery/atmospherics/components/unary/vent_scrubber/on/layer2{
	dir = 8
	},
/obj/structure/cable,
/turf/open/floor/mineral/plastitanium,
/area/shuttle/overmap/aev_p/hermes)
"Gs" = (
/obj/structure/shuttle/engine/heater,
/obj/machinery/atmospherics/pipe/smart/manifold4w/orange/visible,
/obj/effect/spawner/structure/window/reinforced/plasma/plastitanium,
/obj/machinery/door/poddoor/shutters{
	id = "hermes shutter";
	name = "AEV Hermes Shutter"
	},
/turf/open/floor/plating,
/area/shuttle/overmap/aev_p/hermes)
"GS" = (
/obj/effect/turf_decal/tile/neutral/fourcorners,
/obj/effect/turf_decal/bot,
/obj/structure/ore_box,
/obj/machinery/airalarm/directional/east,
/turf/open/floor/iron/dark/textured,
/area/shuttle/overmap/aev_p/hermes)
"GZ" = (
/obj/structure/lattice/catwalk,
/turf/template_noop,
/area/shuttle/overmap/aev_p/hermes)
"Hg" = (
/obj/machinery/atmospherics/pipe/smart/manifold4w/scrubbers/visible/layer2,
/turf/open/floor/mineral/plastitanium,
/area/shuttle/overmap/aev_p/hermes)
"Hm" = (
/obj/effect/spawner/structure/window/reinforced/plasma/plastitanium,
/obj/machinery/door/poddoor/shutters{
	id = "hermes shutter";
	name = "AEV Hermes Shutter"
	},
/turf/open/floor/plating,
/area/shuttle/overmap/aev_p/hermes)
"HC" = (
/obj/machinery/atmospherics/pipe/smart/manifold4w/orange/visible,
/obj/structure/table,
/obj/machinery/cell_charger,
/obj/item/stock_parts/cell/high,
/turf/open/floor/mineral/plastitanium,
/area/shuttle/overmap/aev_p/hermes)
"IR" = (
/obj/effect/turf_decal/stripes/line{
	dir = 10
	},
/obj/machinery/atmospherics/pipe/smart/manifold4w/scrubbers/visible/layer2,
/obj/machinery/atmospherics/pipe/smart/manifold4w/supply/visible/layer4,
/obj/structure/cable,
/turf/open/floor/mineral/plastitanium,
/area/shuttle/overmap/aev_p/hermes)
"IW" = (
/obj/structure/marker_beacon/burgundy,
/obj/structure/lattice/catwalk,
/turf/template_noop,
/area/shuttle/overmap/aev_p/hermes)
"JZ" = (
/obj/machinery/power/apc/auto_name/directional/north,
/obj/effect/turf_decal/stripes/orange/corner{
	dir = 1
	},
/obj/machinery/atmospherics/pipe/smart/manifold4w/scrubbers/visible/layer2,
/obj/machinery/atmospherics/components/unary/vent_pump/on/layer4{
	dir = 8
	},
/obj/structure/cable,
/turf/open/floor/mineral/plastitanium,
/area/shuttle/overmap/aev_p/hermes)
"KS" = (
/obj/structure/chair/comfy/shuttle{
	dir = 1
	},
/obj/effect/turf_decal/stripes/line{
	dir = 5
	},
/turf/open/floor/mineral/plastitanium,
/area/shuttle/overmap/aev_p/hermes)
"Lv" = (
/obj/effect/turf_decal/tile/neutral/fourcorners,
/obj/effect/turf_decal/bot,
/obj/structure/rack,
/obj/item/radio/intercom/directional/north,
/obj/item/storage/toolbox/mechanical,
/obj/item/storage/medkit/regular{
	pixel_y = 0
	},
/obj/item/crowbar/large,
/turf/open/floor/iron/dark/textured,
/area/shuttle/overmap/aev_p/hermes)
"LN" = (
/obj/effect/turf_decal/stripes/line{
	dir = 4
	},
/obj/machinery/holopad,
/turf/open/floor/mineral/plastitanium,
/area/shuttle/overmap/aev_p/hermes)
"MA" = (
/obj/structure/cable,
/turf/open/floor/mineral/plastitanium,
/area/shuttle/overmap/aev_p/hermes)
"NF" = (
/obj/effect/turf_decal/tile/neutral/fourcorners,
/obj/effect/turf_decal/delivery,
/obj/structure/extinguisher_cabinet/directional/east,
/turf/open/floor/iron/dark/textured,
/area/shuttle/overmap/aev_p/hermes)
"PE" = (
/obj/effect/turf_decal/stripes/line,
/obj/effect/turf_decal/stripes/corner{
	dir = 4
	},
/obj/machinery/atmospherics/pipe/smart/manifold4w/scrubbers/visible/layer2,
/obj/machinery/atmospherics/pipe/smart/manifold4w/supply/visible/layer4,
/obj/structure/cable,
/turf/open/floor/mineral/plastitanium,
/area/shuttle/overmap/aev_p/hermes)
"QE" = (
/obj/effect/turf_decal/stripes/line{
	dir = 5
	},
/turf/open/floor/mineral/plastitanium,
/area/shuttle/overmap/aev_p/hermes)
"SL" = (
/obj/effect/turf_decal/stripes/orange/line,
/obj/machinery/atmospherics/pipe/smart/manifold4w/orange/visible,
/obj/structure/closet/crate/internals,
/obj/item/tank/internals/emergency_oxygen,
/obj/item/tank/internals/emergency_oxygen,
/obj/item/clothing/mask/breath,
/obj/item/clothing/mask/breath,
/turf/open/floor/mineral/plastitanium,
/area/shuttle/overmap/aev_p/hermes)
"TG" = (
/obj/effect/turf_decal/stripes/end{
	dir = 4
	},
/obj/machinery/atmospherics/pipe/smart/manifold4w/scrubbers/visible/layer2,
/obj/machinery/atmospherics/pipe/smart/manifold4w/supply/visible/layer4,
/turf/open/floor/mineral/plastitanium,
/area/shuttle/overmap/aev_p/hermes)
"Uy" = (
/obj/effect/turf_decal/stripes/orange/box,
/obj/machinery/light_switch/directional/north,
/obj/machinery/light/small/directional/south,
/obj/machinery/atmospherics/components/binary/pump/off/scrubbers/visible/layer2{
	dir = 8
	},
/obj/machinery/atmospherics/components/binary/pump/off/supply/visible/layer4{
	dir = 4
	},
/obj/structure/cable,
/turf/open/floor/mineral/plastitanium,
/area/shuttle/overmap/aev_p/hermes)
"VE" = (
/obj/effect/spawner/structure/window/reinforced/shuttle,
/obj/machinery/door/poddoor/shutters{
	id = "hermes shutter";
	name = "AEV Hermes Shutter";
	dir = 8
	},
/turf/open/floor/plating,
/area/shuttle/overmap/aev_p/hermes)
"Wj" = (
/obj/effect/turf_decal/stripes/line{
	dir = 8
	},
/obj/machinery/atmospherics/components/unary/vent_pump/on/layer4,
/turf/open/floor/mineral/plastitanium,
/area/shuttle/overmap/aev_p/hermes)
"Ws" = (
/turf/closed/wall/mineral/plastitanium,
/area/shuttle/overmap/aev_p/hermes)
"Xt" = (
/obj/machinery/light/directional/south,
/obj/effect/turf_decal/stripes/line,
/obj/machinery/atmospherics/pipe/smart/manifold4w/scrubbers/visible/layer2,
/obj/machinery/atmospherics/pipe/smart/manifold4w/supply/visible/layer4,
/obj/structure/cable,
/turf/open/floor/mineral/plastitanium,
/area/shuttle/overmap/aev_p/hermes)
"Yk" = (
/obj/machinery/atmospherics/components/unary/engine,
/obj/effect/turf_decal/stripes/orange/line,
/turf/open/floor/plating/airless,
/area/shuttle/overmap/aev_p/hermes)
"Zq" = (
/obj/machinery/firealarm/directional/west,
/obj/effect/turf_decal/stripes/line{
	dir = 8
	},
/obj/machinery/atmospherics/pipe/smart/manifold4w/supply/visible/layer4,
/turf/open/floor/mineral/plastitanium,
/area/shuttle/overmap/aev_p/hermes)

(1,1,1) = {"
nH
nH
nH
IW
aC
aC
nj
ey
nj
Ws
Ws
Ws
nH
"}
(2,1,1) = {"
vW
nj
VE
VE
VE
nj
nj
Uy
nj
uv
cn
Ws
Ws
"}
(3,1,1) = {"
GZ
kI
oj
oj
oj
oj
nj
Au
nj
bu
mg
Gs
Yk
"}
(4,1,1) = {"
GZ
kI
ph
Wj
kf
kf
Zq
IR
nj
Cb
cO
Gs
Yk
"}
(5,1,1) = {"
GZ
kI
QE
Af
vr
sl
Hg
Xt
nj
gO
Ai
Ws
Ws
"}
(6,1,1) = {"
mb
kI
cN
qL
NF
QE
LN
PE
ag
xx
HC
Hm
BD
"}
(7,1,1) = {"
vW
nj
nj
nj
nj
tn
GS
TG
nj
JZ
AG
Ws
Ws
"}
(8,1,1) = {"
nH
nH
IW
aC
nj
nj
nj
Bm
nj
CO
SL
Gs
Yk
"}
(9,1,1) = {"
nH
nH
nH
nH
rm
oF
ns
aF
nj
MA
BF
Gs
Yk
"}
(10,1,1) = {"
nH
nH
nH
nH
rm
eL
KS
jM
nj
oc
zh
Ws
Ws
"}
(11,1,1) = {"
nH
nH
nH
IW
nj
Lv
pu
cQ
nj
Ws
Ws
Ws
nH
"}
(12,1,1) = {"
nH
nH
nH
nH
nj
nj
VE
nj
nj
nH
nH
nH
nH
"}
