//MAP CONVERTED BY dmm2tgm.py THIS HEADER COMMENT PREVENTS RECONVERSION, DO NOT REMOVE
"a" = (
/turf/template_noop,
/area/template_noop)
"b" = (
/obj/structure/table,
/obj/effect/turf_decal/tile/pathfinders_purple/half,
/turf/open/floor/mineral/plastitanium,
/area/shuttle/overmap/aev_p/ghetto)
"c" = (
/obj/structure/table,
/obj/item/clothing/suit/space/eva,
/obj/item/clothing/head/helmet/space,
/obj/effect/turf_decal/tile/pathfinders_purple/half,
/turf/open/floor/mineral/plastitanium,
/area/shuttle/overmap/aev_p/ghetto)
"d" = (
/obj/effect/decal/cleanable/dirt,
/obj/structure/table,
/obj/item/storage/toolbox/mechanical{
	pixel_y = 4
	},
/obj/effect/turf_decal/tile/pathfinders_purple/half,
/turf/open/floor/mineral/plastitanium,
/area/shuttle/overmap/aev_p/ghetto)
"e" = (
/obj/effect/turf_decal/bot,
/obj/effect/turf_decal/tile/pathfinders_purple/half,
/obj/machinery/computer/shuttle/pathfinders_shuttle,
/turf/open/floor/mineral/plastitanium,
/area/shuttle/overmap/aev_p/ghetto)
"f" = (
/obj/structure/table,
/obj/effect/turf_decal/tile/pathfinders_purple/half{
	dir = 4
	},
/turf/open/floor/mineral/plastitanium,
/area/shuttle/overmap/aev_p/ghetto)
"g" = (
/obj/structure/table,
/obj/item/radio,
/obj/effect/turf_decal/tile/pathfinders_purple/half{
	dir = 8
	},
/turf/open/floor/mineral/plastitanium,
/area/shuttle/overmap/aev_p/ghetto)
"h" = (
/obj/structure/chair/comfy/shuttle{
	dir = 1
	},
/turf/open/floor/mineral/titanium/yellow,
/area/shuttle/overmap/aev_p/ghetto)
"i" = (
/obj/structure/rack,
/obj/item/clothing/suit/space/eva,
/obj/item/clothing/head/helmet/space/eva,
/obj/effect/turf_decal/bot,
/turf/open/floor/mineral/plastitanium,
/area/shuttle/overmap/aev_p/ghetto)
"j" = (
/obj/item/clothing/mask/gas{
	pixel_x = -4;
	pixel_y = 4
	},
/obj/item/tank/internals/emergency_oxygen{
	pixel_x = 4
	},
/obj/structure/table,
/obj/effect/turf_decal/tile/pathfinders_purple/half,
/turf/open/floor/mineral/plastitanium,
/area/shuttle/overmap/aev_p/ghetto)
"k" = (
/turf/closed/wall/mineral/titanium/nodiagonal,
/area/shuttle/overmap/aev_p/ghetto)
"l" = (
/obj/item/folder/yellow,
/obj/item/pen,
/obj/effect/decal/cleanable/dirt,
/obj/structure/table,
/obj/effect/turf_decal/tile/pathfinders_purple/half{
	dir = 4
	},
/turf/open/floor/mineral/plastitanium,
/area/shuttle/overmap/aev_p/ghetto)
"m" = (
/obj/effect/decal/cleanable/dirt,
/obj/structure/ore_box,
/obj/effect/turf_decal/box/corners{
	dir = 4
	},
/obj/structure/extinguisher_cabinet{
	pixel_x = 24;
	dir = 4
	},
/turf/open/floor/mineral/plastitanium,
/area/shuttle/overmap/aev_p/ghetto)
"n" = (
/obj/machinery/light/small/directional/south,
/turf/open/floor/mineral/titanium/yellow,
/area/shuttle/overmap/aev_p/ghetto)
"o" = (
/turf/open/floor/mineral/titanium/yellow,
/area/shuttle/overmap/aev_p/ghetto)
"p" = (
/obj/machinery/light/small/directional/south,
/obj/effect/decal/cleanable/dirt,
/turf/open/floor/mineral/titanium/yellow,
/area/shuttle/overmap/aev_p/ghetto)
"q" = (
/obj/effect/spawner/structure/window/reinforced/shuttle,
/turf/open/floor/plating,
/area/shuttle/overmap/aev_p/ghetto)
"r" = (
/obj/structure/sign/departments/cargo,
/turf/closed/wall/mineral/titanium/nodiagonal,
/area/shuttle/overmap/aev_p/ghetto)
"s" = (
/obj/machinery/door/airlock/external/ruin{
	name = "Mining Shuttle External Airlock"
	},
/obj/effect/mapping_helpers/airlock/cyclelink_helper{
	dir = 1
	},
/obj/docking_port/mobile{
	shuttle_id = "pathfinders";
	name = "APV-S Ghetto";
	port_direction = 2
	},
/obj/structure/cable,
/obj/effect/turf_decal/stripes/line,
/obj/effect/turf_decal/stripes/line{
	dir = 1
	},
/obj/effect/mapping_helpers/airlock/access/all/pathfinders/dock,
/turf/open/floor/plating,
/area/shuttle/overmap/aev_p/ghetto)
"t" = (
/obj/item/clothing/suit/hazardvest{
	desc = "A high-visibility lifejacket complete with whistle and slot for oxygen tanks.";
	name = "emergency lifejacket"
	},
/obj/item/clothing/suit/hazardvest{
	desc = "A high-visibility lifejacket complete with whistle and slot for oxygen tanks.";
	name = "emergency lifejacket"
	},
/obj/item/tank/internals/emergency_oxygen{
	pixel_x = 3
	},
/obj/item/tank/internals/emergency_oxygen{
	pixel_x = 3
	},
/obj/item/clothing/mask/breath{
	pixel_x = -3;
	pixel_y = -3
	},
/obj/item/clothing/mask/breath{
	pixel_x = -3;
	pixel_y = -3
	},
/obj/item/clothing/head/hardhat/orange{
	name = "protective hat";
	pixel_y = 9
	},
/obj/item/clothing/head/hardhat/orange{
	name = "protective hat";
	pixel_y = 9
	},
/obj/structure/closet/crate/internals,
/obj/effect/turf_decal/box/corners{
	dir = 1
	},
/obj/machinery/airalarm/directional/west,
/turf/open/floor/mineral/plastitanium,
/area/shuttle/overmap/aev_p/ghetto)
"u" = (
/turf/open/floor/mineral/plastitanium,
/area/shuttle/overmap/aev_p/ghetto)
"v" = (
/obj/effect/turf_decal/box/corners{
	dir = 4
	},
/obj/machinery/light/small/directional/north,
/obj/machinery/portable_atmospherics/canister/carbon_dioxide,
/obj/machinery/atmospherics/components/unary/portables_connector,
/obj/effect/turf_decal/tile/pathfinders_purple/half{
	dir = 4
	},
/turf/open/floor/mineral/plastitanium,
/area/shuttle/overmap/aev_p/ghetto)
"w" = (
/obj/machinery/power/apc/auto_name/directional/east,
/obj/effect/decal/cleanable/dirt,
/obj/structure/cable,
/obj/effect/turf_decal/bot,
/obj/machinery/atmospherics/pipe/smart/manifold4w/orange/hidden,
/turf/open/floor/mineral/plastitanium,
/area/shuttle/overmap/aev_p/ghetto)
"x" = (
/obj/effect/turf_decal/box/corners{
	dir = 8
	},
/obj/machinery/atmospherics/pipe/smart/manifold4w/orange/hidden,
/turf/open/floor/mineral/plastitanium,
/area/shuttle/overmap/aev_p/ghetto)
"y" = (
/obj/effect/turf_decal/box/corners{
	dir = 1
	},
/obj/machinery/light/small/directional/north,
/obj/machinery/atmospherics/components/unary/vent_pump/on{
	dir = 8
	},
/obj/effect/turf_decal/tile/pathfinders_purple/half{
	dir = 8
	},
/turf/open/floor/mineral/plastitanium,
/area/shuttle/overmap/aev_p/ghetto)
"z" = (
/turf/closed/wall/mineral/titanium,
/area/shuttle/overmap/aev_p/ghetto)
"A" = (
/obj/effect/turf_decal/box/corners,
/obj/machinery/atmospherics/pipe/smart/manifold4w/orange/hidden,
/obj/effect/turf_decal/tile/pathfinders_purple/half{
	dir = 4
	},
/turf/open/floor/mineral/plastitanium,
/area/shuttle/overmap/aev_p/ghetto)
"B" = (
/obj/structure/cable,
/obj/machinery/atmospherics/pipe/smart/manifold4w/orange/hidden,
/turf/open/floor/mineral/titanium/yellow,
/area/shuttle/overmap/aev_p/ghetto)
"C" = (
/obj/structure/closet/malf/suits,
/obj/effect/turf_decal/bot,
/turf/open/floor/mineral/plastitanium,
/area/shuttle/overmap/aev_p/ghetto)
"D" = (
/obj/structure/shuttle/engine/heater,
/obj/machinery/atmospherics/pipe/smart/manifold4w/orange/hidden,
/obj/effect/spawner/structure/window/reinforced/shuttle,
/turf/open/floor/plating,
/area/shuttle/overmap/aev_p/ghetto)
"E" = (
/obj/effect/turf_decal/box/corners{
	dir = 8
	},
/obj/structure/cable,
/obj/machinery/atmospherics/pipe/smart/manifold4w/orange/hidden,
/obj/effect/turf_decal/tile/pathfinders_purple/half{
	dir = 8
	},
/turf/open/floor/mineral/plastitanium,
/area/shuttle/overmap/aev_p/ghetto)
"F" = (
/obj/machinery/atmospherics/components/unary/engine{
	pixel_y = -8
	},
/turf/closed/wall/mineral/titanium,
/area/shuttle/overmap/aev_p/ghetto)
"G" = (
/obj/structure/rack,
/obj/item/crowbar/red,
/obj/item/wrench,
/obj/item/flashlight,
/obj/effect/turf_decal/bot,
/obj/machinery/atmospherics/pipe/smart/manifold4w/orange/hidden,
/turf/open/floor/mineral/plastitanium,
/area/shuttle/overmap/aev_p/ghetto)
"H" = (
/obj/machinery/door/airlock/external/ruin{
	name = "Mining Shuttle External Airlock"
	},
/obj/effect/mapping_helpers/airlock/cyclelink_helper,
/obj/structure/cable,
/obj/effect/turf_decal/stripes/line,
/obj/effect/turf_decal/stripes/line{
	dir = 1
	},
/obj/effect/mapping_helpers/airlock/access/all/pathfinders/dock,
/turf/open/floor/plating,
/area/shuttle/overmap/aev_p/ghetto)
"I" = (
/obj/structure/sign/warning/fire,
/turf/closed/wall/mineral/titanium/nodiagonal,
/area/shuttle/overmap/aev_p/ghetto)
"J" = (
/obj/structure/sign/warning/vacuum/external/directional/east,
/obj/structure/cable,
/obj/effect/turf_decal/stripes/line{
	dir = 8
	},
/obj/effect/turf_decal/stripes/line{
	dir = 4
	},
/obj/machinery/light/small/directional/west,
/turf/open/floor/plating,
/area/shuttle/overmap/aev_p/ghetto)
"K" = (
/obj/effect/turf_decal/box/corners,
/obj/structure/cable,
/obj/machinery/atmospherics/pipe/smart/manifold4w/orange/hidden,
/turf/open/floor/mineral/plastitanium,
/area/shuttle/overmap/aev_p/ghetto)
"L" = (
/obj/effect/decal/cleanable/dirt,
/obj/item/stock_parts/cell/high,
/obj/item/screwdriver{
	pixel_y = 18
	},
/obj/structure/table,
/obj/machinery/airalarm/directional/east,
/obj/item/radio/intercom/directional/south,
/obj/effect/turf_decal/tile/pathfinders_purple/half{
	dir = 8
	},
/turf/open/floor/mineral/plastitanium,
/area/shuttle/overmap/aev_p/ghetto)
"Q" = (
/obj/effect/turf_decal/tile/neutral,
/obj/effect/turf_decal/tile/neutral{
	dir = 8
	},
/obj/effect/turf_decal/tile/neutral{
	dir = 4
	},
/obj/effect/turf_decal/tile/neutral{
	dir = 1
	},
/obj/machinery/door/airlock/mining{
	name = "Mining Shuttle Cockpit"
	},
/turf/open/floor/iron/dark,
/area/shuttle/overmap/aev_p/ghetto)
"S" = (
/obj/machinery/atmospherics/pipe/smart/manifold4w/orange/hidden,
/obj/structure/cable,
/turf/open/floor/mineral/plastitanium,
/area/shuttle/overmap/aev_p/ghetto)
"U" = (
/obj/machinery/atmospherics/pipe/smart/manifold4w/orange/hidden,
/turf/open/floor/mineral/plastitanium,
/area/shuttle/overmap/aev_p/ghetto)

(1,1,1) = {"
a
q
q
k
k
k
q
k
z
a
"}
(2,1,1) = {"
q
q
f
l
r
t
x
G
D
F
"}
(3,1,1) = {"
q
c
o
o
q
u
U
u
i
q
"}
(4,1,1) = {"
q
d
h
n
k
v
A
I
k
k
"}
(5,1,1) = {"
q
e
h
o
Q
o
B
H
J
s
"}
(6,1,1) = {"
q
j
h
p
k
y
E
I
k
k
"}
(7,1,1) = {"
q
b
o
o
q
u
S
u
C
q
"}
(8,1,1) = {"
q
q
g
L
k
m
K
w
D
F
"}
(9,1,1) = {"
a
q
q
k
k
k
q
k
z
a
"}
