//MAP CONVERTED BY dmm2tgm.py THIS HEADER COMMENT PREVENTS RECONVERSION, DO NOT REMOVE
"as" = (
/obj/effect/turf_decal/stripes/line{
	dir = 9
	},
/turf/open/floor/mineral/plastitanium,
/area/shuttle/overmap/aev_p/astrum)
"br" = (
/obj/machinery/atmospherics/components/unary/portables_connector/layer2{
	dir = 4
	},
/obj/machinery/portable_atmospherics/canister,
/obj/effect/turf_decal/box/orange,
/turf/open/floor/mineral/plastitanium,
/area/shuttle/overmap/aev_p/astrum)
"bG" = (
/obj/structure/lattice,
/turf/open/space/basic,
/area/shuttle/overmap/aev_p/astrum)
"bR" = (
/obj/effect/turf_decal/stripes/orange/line{
	dir = 1
	},
/obj/machinery/atmospherics/pipe/smart/manifold4w/scrubbers/visible/layer2,
/obj/machinery/atmospherics/pipe/smart/manifold4w/supply/visible/layer4,
/turf/open/floor/mineral/plastitanium,
/area/shuttle/overmap/aev_p/astrum)
"ec" = (
/obj/structure/fans/tiny,
/obj/effect/turf_decal/stripes/line,
/obj/effect/turf_decal/stripes/line{
	dir = 1
	},
/obj/machinery/door/poddoor{
	id = "Hermes blastdoor"
	},
/turf/open/floor/plating,
/area/shuttle/overmap/aev_p/astrum)
"eM" = (
/obj/machinery/atmospherics/pipe/smart/manifold4w/scrubbers/visible/layer2,
/turf/open/floor/mineral/plastitanium,
/area/shuttle/overmap/aev_p/astrum)
"eS" = (
/obj/structure/shuttle/engine/heater,
/obj/machinery/atmospherics/pipe/smart/manifold4w/orange/visible,
/obj/effect/spawner/structure/window/reinforced/plasma/plastitanium,
/obj/machinery/door/poddoor/shutters{
	id = "hermes shutter";
	name = "AEV Hermes Shutter"
	},
/turf/open/floor/plating,
/area/shuttle/overmap/aev_p/astrum)
"fB" = (
/obj/machinery/door/airlock/engineering,
/obj/effect/turf_decal/stripes/orange/box,
/obj/machinery/atmospherics/pipe/smart/manifold4w/scrubbers/visible/layer2,
/obj/machinery/atmospherics/pipe/smart/manifold4w/supply/visible/layer4,
/obj/effect/mapping_helpers/airlock/access/all/pathfinders/dock,
/turf/open/floor/mineral/plastitanium,
/area/shuttle/overmap/aev_p/astrum)
"fI" = (
/obj/effect/turf_decal/stripes/orange/corner,
/obj/machinery/atmospherics/components/unary/portables_connector/layer4{
	dir = 4
	},
/obj/machinery/portable_atmospherics/canister/air,
/obj/effect/turf_decal/box/orange,
/turf/open/floor/mineral/plastitanium,
/area/shuttle/overmap/aev_p/astrum)
"fW" = (
/obj/effect/turf_decal/stripes/line{
	dir = 10
	},
/obj/machinery/atmospherics/components/unary/vent_scrubber/on/layer2{
	dir = 8
	},
/obj/machinery/atmospherics/pipe/smart/manifold4w/supply/visible/layer4,
/turf/open/floor/mineral/plastitanium,
/area/shuttle/overmap/aev_p/astrum)
"fX" = (
/obj/structure/lattice/catwalk,
/obj/machinery/button/door/directional/east{
	id = "Hermes blastdoor";
	name = "Blast door Toggle"
	},
/turf/open/space/basic,
/area/shuttle/overmap/aev_p/astrum)
"gz" = (
/obj/machinery/atmospherics/components/unary/engine,
/obj/effect/turf_decal/stripes/orange/line,
/turf/open/floor/plating,
/area/shuttle/overmap/aev_p/astrum)
"gZ" = (
/obj/effect/turf_decal/tile/neutral/fourcorners,
/obj/effect/turf_decal/delivery,
/obj/effect/spawner/random/structure/crate_loot,
/obj/machinery/light/directional/east,
/turf/open/floor/iron/dark/textured,
/area/shuttle/overmap/aev_p/astrum)
"hr" = (
/obj/machinery/light/red/directional/north,
/obj/machinery/atmospherics/pipe/smart/manifold4w/scrubbers/visible/layer2,
/obj/machinery/atmospherics/pipe/smart/manifold4w/supply/visible/layer4,
/turf/open/floor/mineral/plastitanium,
/area/shuttle/overmap/aev_p/astrum)
"hX" = (
/obj/effect/turf_decal/stripes/orange/line,
/obj/machinery/atmospherics/pipe/smart/manifold4w/orange/visible,
/obj/structure/closet/secure_closet/miner,
/obj/machinery/atmospherics/pipe/smart/manifold4w/supply/visible/layer4,
/turf/open/floor/mineral/plastitanium,
/area/shuttle/overmap/aev_p/astrum)
"ii" = (
/obj/effect/turf_decal/stripes/orange/corner,
/obj/machinery/atmospherics/pipe/smart/manifold4w/orange/visible,
/obj/structure/table,
/obj/machinery/recharger,
/turf/open/floor/mineral/plastitanium,
/area/shuttle/overmap/aev_p/astrum)
"jG" = (
/obj/effect/turf_decal/tile/neutral/fourcorners,
/obj/effect/turf_decal/bot,
/obj/machinery/suit_storage_unit/hardsuit/mining,
/obj/item/radio/intercom/directional/east,
/turf/open/floor/iron/dark/textured,
/area/shuttle/overmap/aev_p/astrum)
"jR" = (
/obj/machinery/firealarm/directional/west,
/obj/effect/turf_decal/stripes/line{
	dir = 8
	},
/obj/machinery/atmospherics/pipe/smart/manifold4w/supply/visible/layer4,
/turf/open/floor/mineral/plastitanium,
/area/shuttle/overmap/aev_p/astrum)
"ky" = (
/obj/effect/turf_decal/stripes/line{
	dir = 4
	},
/obj/machinery/atmospherics/pipe/smart/manifold4w/scrubbers/visible/layer2,
/turf/open/floor/mineral/plastitanium,
/area/shuttle/overmap/aev_p/astrum)
"lX" = (
/obj/effect/turf_decal/stripes/orange/line,
/obj/machinery/atmospherics/pipe/smart/manifold4w/orange/visible,
/obj/effect/turf_decal/vg_decals/atmos/carbon_dioxide,
/obj/machinery/meter,
/turf/open/floor/mineral/plastitanium,
/area/shuttle/overmap/aev_p/astrum)
"no" = (
/obj/effect/turf_decal/stripes/line{
	dir = 4
	},
/obj/machinery/holopad,
/turf/open/floor/mineral/plastitanium,
/area/shuttle/overmap/aev_p/astrum)
"nr" = (
/obj/machinery/power/apc/auto_name/directional/north,
/obj/effect/turf_decal/stripes/orange/corner{
	dir = 1
	},
/obj/machinery/atmospherics/pipe/smart/manifold4w/scrubbers/visible/layer2,
/obj/machinery/atmospherics/components/unary/vent_pump/on/layer4{
	dir = 8
	},
/turf/open/floor/mineral/plastitanium,
/area/shuttle/overmap/aev_p/astrum)
"nW" = (
/obj/machinery/atmospherics/pipe/smart/manifold4w/orange/visible,
/obj/structure/table,
/obj/machinery/cell_charger,
/obj/item/stock_parts/cell/high,
/turf/open/floor/mineral/plastitanium,
/area/shuttle/overmap/aev_p/astrum)
"oe" = (
/obj/machinery/firealarm/directional/north,
/obj/effect/turf_decal/stripes/orange/corner{
	dir = 4
	},
/obj/machinery/atmospherics/pipe/smart/manifold4w/scrubbers/visible/layer2,
/obj/machinery/atmospherics/pipe/smart/manifold4w/supply/visible/layer4,
/turf/open/floor/mineral/plastitanium,
/area/shuttle/overmap/aev_p/astrum)
"oi" = (
/obj/machinery/light/directional/south,
/obj/effect/turf_decal/stripes/line,
/obj/machinery/atmospherics/pipe/smart/manifold4w/scrubbers/visible/layer2,
/obj/machinery/atmospherics/pipe/smart/manifold4w/supply/visible/layer4,
/turf/open/floor/mineral/plastitanium,
/area/shuttle/overmap/aev_p/astrum)
"oM" = (
/obj/structure/closet/crate,
/obj/effect/spawner/random/maintenance,
/obj/item/crowbar/large,
/obj/effect/turf_decal/tile/neutral/fourcorners,
/obj/effect/turf_decal/delivery,
/obj/machinery/button/door/directional/east{
	id = "Hermes blastdoor";
	name = "Blast door Toggle"
	},
/turf/open/floor/iron/dark/textured,
/area/shuttle/overmap/aev_p/astrum)
"pg" = (
/obj/effect/turf_decal/tile/neutral/fourcorners,
/obj/effect/turf_decal/bot,
/obj/structure/rack,
/obj/item/radio/intercom/directional/north,
/obj/item/storage/toolbox/mechanical,
/obj/item/storage/medkit/regular{
	pixel_y = 0
	},
/obj/item/crowbar/large,
/turf/open/floor/iron/dark/textured,
/area/shuttle/overmap/aev_p/astrum)
"ph" = (
/turf/closed/wall/mineral/titanium,
/area/shuttle/overmap/aev_p/astrum)
"ps" = (
/obj/effect/turf_decal/stripes/line{
	dir = 8
	},
/obj/machinery/atmospherics/pipe/smart/manifold4w/supply/visible/layer4,
/turf/open/floor/mineral/plastitanium,
/area/shuttle/overmap/aev_p/astrum)
"qJ" = (
/obj/machinery/computer/shuttle/pathfinders_shuttle,
/obj/effect/turf_decal/tile/neutral/fourcorners,
/obj/effect/turf_decal/bot,
/turf/open/floor/iron/dark/textured,
/area/shuttle/overmap/aev_p/astrum)
"ro" = (
/obj/effect/turf_decal/tile/neutral/fourcorners,
/obj/effect/turf_decal/delivery,
/obj/structure/extinguisher_cabinet/directional/east,
/turf/open/floor/iron/dark/textured,
/area/shuttle/overmap/aev_p/astrum)
"rB" = (
/obj/effect/turf_decal/stripes/orange/line,
/obj/machinery/atmospherics/pipe/smart/manifold4w/orange/visible,
/obj/machinery/autolathe,
/turf/open/floor/mineral/plastitanium,
/area/shuttle/overmap/aev_p/astrum)
"sF" = (
/obj/effect/turf_decal/stripes/line,
/obj/effect/turf_decal/stripes/corner{
	dir = 4
	},
/obj/machinery/atmospherics/pipe/smart/manifold4w/scrubbers/visible/layer2,
/obj/machinery/atmospherics/pipe/smart/manifold4w/supply/visible/layer4,
/turf/open/floor/mineral/plastitanium,
/area/shuttle/overmap/aev_p/astrum)
"tn" = (
/obj/effect/turf_decal/tile/neutral/fourcorners,
/obj/effect/turf_decal/bot,
/obj/machinery/modular_computer/console/preset/id,
/turf/open/floor/iron/dark/textured,
/area/shuttle/overmap/aev_p/astrum)
"to" = (
/obj/effect/turf_decal/tile/neutral/fourcorners,
/obj/effect/turf_decal/bot,
/obj/structure/table,
/obj/machinery/button/door/directional{
	pixel_y = 6;
	pixel_x = 6;
	id = "hermes shutter";
	name = "Hermes Shutter Toggle"
	},
/obj/machinery/button/door/directional{
	pixel_y = 6;
	pixel_x = -5;
	id = "Hermes blastdoor";
	name = "Blast door Toggle"
	},
/turf/open/floor/iron/dark/textured,
/area/shuttle/overmap/aev_p/astrum)
"tY" = (
/obj/effect/spawner/structure/window/reinforced/shuttle,
/obj/machinery/door/poddoor/shutters{
	id = "hermes shutter";
	name = "AEV Hermes Shutter";
	dir = 8
	},
/turf/open/floor/plating,
/area/shuttle/overmap/aev_p/astrum)
"tZ" = (
/turf/open/space/basic,
/area/space)
"xF" = (
/obj/structure/extinguisher_cabinet/directional/north,
/obj/machinery/atmospherics/pipe/smart/manifold4w/scrubbers/visible/layer2,
/obj/machinery/atmospherics/pipe/smart/manifold4w/supply/visible/layer4,
/turf/open/floor/mineral/plastitanium,
/area/shuttle/overmap/aev_p/astrum)
"xK" = (
/obj/machinery/telecomms/relay/preset/pathfinders,
/turf/open/floor/mineral/plastitanium,
/area/shuttle/overmap/aev_p/astrum)
"yu" = (
/obj/structure/chair/comfy/shuttle{
	dir = 4
	},
/obj/effect/turf_decal/tile/neutral/fourcorners,
/obj/effect/turf_decal/bot,
/turf/open/floor/iron/dark/textured,
/area/shuttle/overmap/aev_p/astrum)
"zk" = (
/obj/machinery/door/airlock/command{
	dir = 4
	},
/obj/effect/turf_decal/stripes/box,
/obj/machinery/atmospherics/pipe/smart/manifold4w/scrubbers/visible/layer2,
/obj/machinery/atmospherics/pipe/smart/manifold4w/supply/visible/layer4,
/obj/effect/mapping_helpers/airlock/access/all/pathfinders/dock,
/turf/open/floor/mineral/plastitanium,
/area/shuttle/overmap/aev_p/astrum)
"zH" = (
/obj/structure/marker_beacon/burgundy,
/obj/structure/lattice/catwalk,
/turf/open/space/basic,
/area/shuttle/overmap/aev_p/astrum)
"Aa" = (
/obj/effect/turf_decal/stripes/line{
	dir = 4
	},
/obj/machinery/atmospherics/components/unary/vent_scrubber/on/layer2,
/turf/open/floor/mineral/plastitanium,
/area/shuttle/overmap/aev_p/astrum)
"AC" = (
/obj/effect/turf_decal/stripes/orange/line,
/obj/machinery/atmospherics/pipe/smart/manifold4w/orange/visible,
/obj/structure/closet/crate/internals,
/obj/item/tank/internals/emergency_oxygen,
/obj/item/tank/internals/emergency_oxygen,
/obj/item/clothing/mask/breath,
/obj/item/clothing/mask/breath,
/turf/open/floor/mineral/plastitanium,
/area/shuttle/overmap/aev_p/astrum)
"Be" = (
/obj/effect/turf_decal/stripes/orange/corner{
	dir = 8
	},
/obj/machinery/atmospherics/pipe/smart/manifold4w/orange/visible,
/obj/machinery/recharge_station,
/turf/open/floor/mineral/plastitanium,
/area/shuttle/overmap/aev_p/astrum)
"BJ" = (
/obj/structure/marker_beacon/burgundy,
/turf/closed/wall/mineral/titanium,
/area/shuttle/overmap/aev_p/astrum)
"Cl" = (
/obj/effect/turf_decal/stripes/orange/corner{
	dir = 8
	},
/obj/machinery/atmospherics/components/unary/portables_connector{
	dir = 8
	},
/obj/machinery/portable_atmospherics/canister/carbon_dioxide,
/obj/effect/turf_decal/box/orange,
/turf/open/floor/mineral/plastitanium,
/area/shuttle/overmap/aev_p/astrum)
"Ea" = (
/obj/effect/spawner/structure/window/reinforced/plasma/plastitanium,
/obj/machinery/door/poddoor/shutters{
	id = "hermes shutter";
	name = "AEV Hermes Shutter"
	},
/turf/open/floor/plating,
/area/shuttle/overmap/aev_p/astrum)
"FT" = (
/obj/effect/turf_decal/stripes/line{
	dir = 9
	},
/obj/structure/chair/comfy/shuttle{
	dir = 1
	},
/obj/machinery/firealarm/directional/west,
/turf/open/floor/mineral/plastitanium,
/area/shuttle/overmap/aev_p/astrum)
"HX" = (
/obj/effect/turf_decal/tile/neutral/fourcorners,
/obj/effect/turf_decal/bot,
/obj/structure/table,
/obj/machinery/recharger,
/turf/open/floor/iron/dark/textured,
/area/shuttle/overmap/aev_p/astrum)
"Im" = (
/obj/machinery/door/airlock/external{
	dir = 4
	},
/obj/effect/mapping_helpers/airlock/cyclelink_helper{
	dir = 4
	},
/obj/structure/fans/tiny,
/obj/docking_port/mobile{
	dir = 4;
	name = "APV-S Hermes";
	shuttle_id = "pathfinders_hermes"
	},
/obj/effect/turf_decal/stripes/orange/box,
/obj/machinery/atmospherics/pipe/smart/manifold4w/scrubbers/visible/layer2,
/obj/machinery/atmospherics/pipe/smart/manifold4w/supply/visible/layer4,
/obj/effect/mapping_helpers/airlock/access/all/pathfinders/dock,
/turf/open/floor/mineral/plastitanium,
/area/shuttle/overmap/aev_p/astrum)
"Jg" = (
/obj/effect/turf_decal/stripes/corner{
	dir = 4
	},
/obj/machinery/atmospherics/pipe/smart/manifold4w/scrubbers/visible/layer2,
/turf/open/floor/mineral/plastitanium,
/area/shuttle/overmap/aev_p/astrum)
"JS" = (
/turf/closed/wall/mineral/plastitanium,
/area/shuttle/overmap/aev_p/astrum)
"Ld" = (
/obj/effect/spawner/structure/window/reinforced/shuttle,
/obj/machinery/door/poddoor/shutters{
	id = "hermes shutter";
	name = "AEV Hermes Shutter"
	},
/turf/open/floor/plating,
/area/shuttle/overmap/aev_p/astrum)
"Lm" = (
/obj/effect/turf_decal/tile/neutral/fourcorners,
/obj/effect/turf_decal/bot,
/obj/structure/ore_box,
/obj/machinery/airalarm/directional/east,
/turf/open/floor/iron/dark/textured,
/area/shuttle/overmap/aev_p/astrum)
"OC" = (
/obj/structure/lattice/catwalk,
/turf/open/space/basic,
/area/shuttle/overmap/aev_p/astrum)
"RP" = (
/obj/machinery/door/airlock/external{
	dir = 4
	},
/obj/effect/mapping_helpers/airlock/cyclelink_helper{
	dir = 8
	},
/obj/effect/turf_decal/stripes/orange/box,
/obj/machinery/atmospherics/pipe/smart/manifold4w/scrubbers/visible/layer2,
/obj/machinery/atmospherics/pipe/smart/manifold4w/supply/visible/layer4,
/obj/effect/mapping_helpers/airlock/access/all/pathfinders/dock,
/turf/open/floor/mineral/plastitanium,
/area/shuttle/overmap/aev_p/astrum)
"SI" = (
/obj/machinery/light/red/directional/north,
/obj/machinery/atmospherics/components/unary/vent_scrubber/on/layer2{
	dir = 8
	},
/turf/open/floor/mineral/plastitanium,
/area/shuttle/overmap/aev_p/astrum)
"Un" = (
/obj/effect/turf_decal/stripes/orange/box,
/obj/machinery/light_switch/directional/north,
/obj/machinery/light/small/directional/south,
/obj/machinery/atmospherics/components/binary/pump/off/scrubbers/visible/layer2{
	dir = 8
	},
/obj/machinery/atmospherics/components/binary/pump/off/supply/visible/layer4{
	dir = 4
	},
/turf/open/floor/mineral/plastitanium,
/area/shuttle/overmap/aev_p/astrum)
"Vd" = (
/obj/structure/chair/comfy/shuttle{
	dir = 1
	},
/obj/effect/turf_decal/stripes/line{
	dir = 5
	},
/turf/open/floor/mineral/plastitanium,
/area/shuttle/overmap/aev_p/astrum)
"Wm" = (
/obj/effect/turf_decal/stripes/line{
	dir = 5
	},
/turf/open/floor/mineral/plastitanium,
/area/shuttle/overmap/aev_p/astrum)
"XP" = (
/obj/effect/turf_decal/stripes/line{
	dir = 10
	},
/obj/machinery/atmospherics/pipe/smart/manifold4w/scrubbers/visible/layer2,
/obj/machinery/atmospherics/pipe/smart/manifold4w/supply/visible/layer4,
/turf/open/floor/mineral/plastitanium,
/area/shuttle/overmap/aev_p/astrum)
"Yq" = (
/obj/effect/turf_decal/stripes/line{
	dir = 8
	},
/obj/machinery/atmospherics/components/unary/vent_pump/on/layer4,
/turf/open/floor/mineral/plastitanium,
/area/shuttle/overmap/aev_p/astrum)
"Yy" = (
/turf/open/floor/mineral/plastitanium,
/area/shuttle/overmap/aev_p/astrum)
"ZJ" = (
/obj/effect/turf_decal/stripes/end{
	dir = 4
	},
/obj/machinery/atmospherics/pipe/smart/manifold4w/scrubbers/visible/layer2,
/obj/machinery/atmospherics/pipe/smart/manifold4w/supply/visible/layer4,
/turf/open/floor/mineral/plastitanium,
/area/shuttle/overmap/aev_p/astrum)
"ZV" = (
/obj/effect/turf_decal/stripes/line{
	dir = 6
	},
/obj/machinery/light/directional/south,
/obj/machinery/atmospherics/components/unary/vent_pump/on/layer4{
	dir = 8
	},
/turf/open/floor/mineral/plastitanium,
/area/shuttle/overmap/aev_p/astrum)

(1,1,1) = {"
tZ
tZ
tZ
zH
bG
bG
ph
Im
ph
JS
JS
JS
tZ
"}
(2,1,1) = {"
BJ
ph
tY
tY
tY
ph
ph
Un
ph
br
fI
JS
JS
"}
(3,1,1) = {"
OC
ec
yu
yu
yu
yu
ph
RP
ph
xF
hX
eS
gz
"}
(4,1,1) = {"
OC
ec
as
Yq
ps
ps
jR
XP
ph
hr
rB
eS
gz
"}
(5,1,1) = {"
OC
ec
Wm
Aa
ky
Jg
eM
oi
ph
oe
Be
JS
JS
"}
(6,1,1) = {"
fX
ec
oM
gZ
ro
Wm
no
sF
fB
bR
nW
Ea
bG
"}
(7,1,1) = {"
BJ
ph
ph
ph
ph
jG
Lm
ZJ
ph
nr
ii
JS
JS
"}
(8,1,1) = {"
tZ
tZ
zH
bG
ph
ph
ph
zk
ph
SI
AC
eS
gz
"}
(9,1,1) = {"
tZ
tZ
tZ
tZ
Ld
tn
FT
fW
ph
Yy
lX
eS
gz
"}
(10,1,1) = {"
tZ
tZ
tZ
tZ
Ld
qJ
Vd
ZV
ph
xK
Cl
JS
JS
"}
(11,1,1) = {"
tZ
tZ
tZ
zH
ph
pg
to
HX
ph
JS
JS
JS
tZ
"}
(12,1,1) = {"
tZ
tZ
tZ
tZ
ph
ph
tY
ph
ph
tZ
tZ
tZ
tZ
"}
