//MAP CONVERTED BY dmm2tgm.py THIS HEADER COMMENT PREVENTS RECONVERSION, DO NOT REMOVE
"ag" = (
/obj/machinery/door/airlock/engineering{
	name = "Hermes Engineering"
	},
/obj/effect/turf_decal/stripes/orange/box,
/obj/machinery/atmospherics/pipe/smart/manifold4w/scrubbers/visible/layer2,
/obj/machinery/atmospherics/pipe/smart/manifold4w/supply/visible/layer4,
/obj/effect/mapping_helpers/airlock/access/all/pathfinders/dock,
/obj/machinery/door/firedoor,
/turf/open/floor/mineral/plastitanium,
/area/shuttle/overmap/aev_p/astrum)
"aF" = (
/obj/effect/turf_decal/stripes/line{
	dir = 10
	},
/obj/machinery/atmospherics/components/unary/vent_scrubber/on/layer2{
	dir = 8
	},
/obj/machinery/atmospherics/pipe/smart/manifold4w/supply/visible/layer4,
/turf/open/floor/mineral/plastitanium,
/area/shuttle/overmap/aev_p/astrum)
"bu" = (
/obj/structure/extinguisher_cabinet/directional/north,
/obj/machinery/atmospherics/pipe/smart/manifold4w/scrubbers/visible/layer2,
/obj/machinery/atmospherics/pipe/smart/manifold4w/supply/visible/layer4,
/turf/open/floor/mineral/plastitanium,
/area/shuttle/overmap/aev_p/astrum)
"cn" = (
/obj/effect/turf_decal/stripes/orange/corner,
/obj/machinery/atmospherics/components/unary/portables_connector/layer4{
	dir = 4
	},
/obj/machinery/portable_atmospherics/canister/air,
/obj/effect/turf_decal/box/orange,
/turf/open/floor/mineral/plastitanium,
/area/shuttle/overmap/aev_p/astrum)
"cN" = (
/obj/structure/closet/crate,
/obj/effect/spawner/random/maintenance,
/obj/item/crowbar/large,
/obj/effect/turf_decal/tile/neutral/fourcorners,
/obj/effect/turf_decal/delivery,
/obj/machinery/button/door/directional/east{
	id = "Hermes blastdoor";
	name = "Blast door Toggle"
	},
/turf/open/floor/iron/dark/textured,
/area/shuttle/overmap/aev_p/astrum)
"cO" = (
/obj/effect/turf_decal/stripes/orange/line,
/obj/machinery/atmospherics/pipe/smart/manifold4w/orange/visible,
/obj/machinery/autolathe,
/turf/open/floor/mineral/plastitanium,
/area/shuttle/overmap/aev_p/astrum)
"cQ" = (
/obj/effect/turf_decal/tile/neutral/fourcorners,
/obj/effect/turf_decal/bot,
/obj/structure/table,
/obj/machinery/recharger,
/turf/open/floor/iron/dark/textured,
/area/shuttle/overmap/aev_p/astrum)
"ey" = (
/obj/machinery/door/airlock/external{
	dir = 4
	},
/obj/effect/mapping_helpers/airlock/cyclelink_helper{
	dir = 4
	},
/obj/structure/fans/tiny,
/obj/docking_port/mobile{
	dir = 4;
	name = "APV-S Hermes";
	shuttle_id = "pathfinders_hermes"
	},
/obj/effect/turf_decal/stripes/orange/box,
/obj/machinery/atmospherics/pipe/smart/manifold4w/scrubbers/visible/layer2,
/obj/machinery/atmospherics/pipe/smart/manifold4w/supply/visible/layer4,
/obj/effect/mapping_helpers/airlock/access/all/pathfinders/dock,
/obj/machinery/door/firedoor{
	dir = 8
	},
/turf/open/floor/mineral/plastitanium,
/area/shuttle/overmap/aev_p/astrum)
"eL" = (
/obj/machinery/computer/shuttle/pathfinders_shuttle,
/obj/effect/turf_decal/tile/neutral/fourcorners,
/obj/effect/turf_decal/bot,
/turf/open/floor/iron/dark/textured,
/area/shuttle/overmap/aev_p/astrum)
"gO" = (
/obj/machinery/firealarm/directional/north,
/obj/effect/turf_decal/stripes/orange/corner{
	dir = 4
	},
/obj/machinery/atmospherics/pipe/smart/manifold4w/scrubbers/visible/layer2,
/obj/machinery/atmospherics/pipe/smart/manifold4w/supply/visible/layer4,
/turf/open/floor/mineral/plastitanium,
/area/shuttle/overmap/aev_p/astrum)
"jM" = (
/obj/effect/turf_decal/stripes/line{
	dir = 6
	},
/obj/machinery/light/directional/south,
/obj/machinery/atmospherics/components/unary/vent_pump/on/layer4{
	dir = 8
	},
/turf/open/floor/mineral/plastitanium,
/area/shuttle/overmap/aev_p/astrum)
"kf" = (
/obj/effect/turf_decal/stripes/line{
	dir = 8
	},
/obj/machinery/atmospherics/pipe/smart/manifold4w/supply/visible/layer4,
/turf/open/floor/mineral/plastitanium,
/area/shuttle/overmap/aev_p/astrum)
"kI" = (
/obj/structure/fans/tiny,
/obj/effect/turf_decal/stripes/line,
/obj/effect/turf_decal/stripes/line{
	dir = 1
	},
/obj/machinery/door/poddoor{
	id = "Hermes blastdoor"
	},
/turf/open/floor/plating,
/area/shuttle/overmap/aev_p/astrum)
"mb" = (
/obj/structure/lattice/catwalk,
/obj/machinery/button/door/directional/east{
	id = "Hermes blastdoor";
	name = "Blast door Toggle"
	},
/turf/open/space/basic,
/area/shuttle/overmap/aev_p/astrum)
"mg" = (
/obj/effect/turf_decal/stripes/orange/line,
/obj/machinery/atmospherics/pipe/smart/manifold4w/orange/visible,
/obj/structure/closet/secure_closet/miner,
/obj/machinery/atmospherics/pipe/smart/manifold4w/supply/visible/layer4,
/turf/open/floor/mineral/plastitanium,
/area/shuttle/overmap/aev_p/astrum)
"nj" = (
/turf/closed/wall/mineral/titanium,
/area/shuttle/overmap/aev_p/astrum)
"ns" = (
/obj/effect/turf_decal/stripes/line{
	dir = 9
	},
/obj/structure/chair/comfy/shuttle{
	dir = 1
	},
/obj/machinery/firealarm/directional/west,
/turf/open/floor/mineral/plastitanium,
/area/shuttle/overmap/aev_p/astrum)
"nH" = (
/turf/open/space/basic,
/area/space)
"oc" = (
/obj/machinery/telecomms/relay/preset/pathfinders,
/turf/open/floor/mineral/plastitanium,
/area/shuttle/overmap/aev_p/astrum)
"oj" = (
/obj/structure/chair/comfy/shuttle{
	dir = 4
	},
/obj/effect/turf_decal/tile/neutral/fourcorners,
/obj/effect/turf_decal/bot,
/turf/open/floor/iron/dark/textured,
/area/shuttle/overmap/aev_p/astrum)
"oF" = (
/obj/effect/turf_decal/tile/neutral/fourcorners,
/obj/effect/turf_decal/bot,
/obj/machinery/modular_computer/console/preset/id,
/turf/open/floor/iron/dark/textured,
/area/shuttle/overmap/aev_p/astrum)
"ph" = (
/obj/effect/turf_decal/stripes/line{
	dir = 9
	},
/turf/open/floor/mineral/plastitanium,
/area/shuttle/overmap/aev_p/astrum)
"pu" = (
/obj/effect/turf_decal/tile/neutral/fourcorners,
/obj/effect/turf_decal/bot,
/obj/structure/table,
/obj/machinery/button/door/directional{
	pixel_y = 6;
	pixel_x = 6;
	id = "hermes shutter";
	name = "Hermes Shutter Toggle"
	},
/obj/machinery/button/door/directional{
	pixel_y = 6;
	pixel_x = -5;
	id = "Hermes blastdoor";
	name = "Blast door Toggle"
	},
/turf/open/floor/iron/dark/textured,
/area/shuttle/overmap/aev_p/astrum)
"qL" = (
/obj/effect/turf_decal/tile/neutral/fourcorners,
/obj/effect/turf_decal/delivery,
/obj/effect/spawner/random/structure/crate_loot,
/obj/machinery/light/directional/east,
/turf/open/floor/iron/dark/textured,
/area/shuttle/overmap/aev_p/astrum)
"rm" = (
/obj/effect/spawner/structure/window/reinforced/shuttle,
/obj/machinery/door/poddoor/shutters{
	id = "hermes shutter";
	name = "AEV Hermes Shutter"
	},
/turf/open/floor/plating,
/area/shuttle/overmap/aev_p/astrum)
"sl" = (
/obj/effect/turf_decal/stripes/corner{
	dir = 4
	},
/obj/machinery/atmospherics/pipe/smart/manifold4w/scrubbers/visible/layer2,
/turf/open/floor/mineral/plastitanium,
/area/shuttle/overmap/aev_p/astrum)
"tn" = (
/obj/effect/turf_decal/tile/neutral/fourcorners,
/obj/effect/turf_decal/bot,
/obj/machinery/suit_storage_unit/hardsuit/mining,
/obj/item/radio/intercom/directional/east,
/turf/open/floor/iron/dark/textured,
/area/shuttle/overmap/aev_p/astrum)
"uv" = (
/obj/machinery/atmospherics/components/unary/portables_connector/layer2{
	dir = 4
	},
/obj/machinery/portable_atmospherics/canister,
/obj/effect/turf_decal/box/orange,
/turf/open/floor/mineral/plastitanium,
/area/shuttle/overmap/aev_p/astrum)
"vr" = (
/obj/effect/turf_decal/stripes/line{
	dir = 4
	},
/obj/machinery/atmospherics/pipe/smart/manifold4w/scrubbers/visible/layer2,
/turf/open/floor/mineral/plastitanium,
/area/shuttle/overmap/aev_p/astrum)
"vW" = (
/obj/structure/marker_beacon/burgundy,
/turf/closed/wall/mineral/titanium,
/area/shuttle/overmap/aev_p/astrum)
"xx" = (
/obj/effect/turf_decal/stripes/orange/line{
	dir = 1
	},
/obj/machinery/atmospherics/pipe/smart/manifold4w/scrubbers/visible/layer2,
/obj/machinery/atmospherics/pipe/smart/manifold4w/supply/visible/layer4,
/turf/open/floor/mineral/plastitanium,
/area/shuttle/overmap/aev_p/astrum)
"zh" = (
/obj/effect/turf_decal/stripes/orange/corner{
	dir = 8
	},
/obj/machinery/atmospherics/components/unary/portables_connector{
	dir = 8
	},
/obj/machinery/portable_atmospherics/canister/carbon_dioxide,
/obj/effect/turf_decal/box/orange,
/turf/open/floor/mineral/plastitanium,
/area/shuttle/overmap/aev_p/astrum)
"Af" = (
/obj/effect/turf_decal/stripes/line{
	dir = 4
	},
/obj/machinery/atmospherics/components/unary/vent_scrubber/on/layer2,
/turf/open/floor/mineral/plastitanium,
/area/shuttle/overmap/aev_p/astrum)
"Ai" = (
/obj/effect/turf_decal/stripes/orange/corner{
	dir = 8
	},
/obj/machinery/atmospherics/pipe/smart/manifold4w/orange/visible,
/obj/machinery/recharge_station,
/turf/open/floor/mineral/plastitanium,
/area/shuttle/overmap/aev_p/astrum)
"Au" = (
/obj/machinery/door/airlock/external{
	dir = 4
	},
/obj/effect/mapping_helpers/airlock/cyclelink_helper{
	dir = 8
	},
/obj/effect/turf_decal/stripes/orange/box,
/obj/machinery/atmospherics/pipe/smart/manifold4w/scrubbers/visible/layer2,
/obj/machinery/atmospherics/pipe/smart/manifold4w/supply/visible/layer4,
/obj/effect/mapping_helpers/airlock/access/all/pathfinders/dock,
/obj/machinery/door/firedoor{
	dir = 8
	},
/turf/open/floor/mineral/plastitanium,
/area/shuttle/overmap/aev_p/astrum)
"AG" = (
/obj/effect/turf_decal/stripes/orange/corner,
/obj/machinery/atmospherics/pipe/smart/manifold4w/orange/visible,
/obj/structure/table,
/obj/machinery/recharger,
/turf/open/floor/mineral/plastitanium,
/area/shuttle/overmap/aev_p/astrum)
"Bm" = (
/obj/machinery/door/airlock/command{
	dir = 4;
	name = "Hermes Bridge"
	},
/obj/effect/turf_decal/stripes/box,
/obj/machinery/atmospherics/pipe/smart/manifold4w/scrubbers/visible/layer2,
/obj/machinery/atmospherics/pipe/smart/manifold4w/supply/visible/layer4,
/obj/effect/mapping_helpers/airlock/access/all/pathfinders/dock,
/obj/machinery/door/firedoor{
	dir = 8
	},
/turf/open/floor/mineral/plastitanium,
/area/shuttle/overmap/aev_p/astrum)
"BD" = (
/obj/structure/lattice,
/turf/open/space/basic,
/area/shuttle/overmap/aev_p/astrum)
"BF" = (
/obj/effect/turf_decal/stripes/orange/line,
/obj/machinery/atmospherics/pipe/smart/manifold4w/orange/visible,
/obj/effect/turf_decal/vg_decals/atmos/carbon_dioxide,
/obj/machinery/meter,
/turf/open/floor/mineral/plastitanium,
/area/shuttle/overmap/aev_p/astrum)
"Cb" = (
/obj/machinery/light/red/directional/north,
/obj/machinery/atmospherics/pipe/smart/manifold4w/scrubbers/visible/layer2,
/obj/machinery/atmospherics/pipe/smart/manifold4w/supply/visible/layer4,
/turf/open/floor/mineral/plastitanium,
/area/shuttle/overmap/aev_p/astrum)
"CO" = (
/obj/machinery/light/red/directional/north,
/obj/machinery/atmospherics/components/unary/vent_scrubber/on/layer2{
	dir = 8
	},
/turf/open/floor/mineral/plastitanium,
/area/shuttle/overmap/aev_p/astrum)
"Gs" = (
/obj/structure/shuttle/engine/heater,
/obj/machinery/atmospherics/pipe/smart/manifold4w/orange/visible,
/obj/effect/spawner/structure/window/reinforced/plasma/plastitanium,
/obj/machinery/door/poddoor/shutters{
	id = "hermes shutter";
	name = "AEV Hermes Shutter"
	},
/turf/open/floor/plating,
/area/shuttle/overmap/aev_p/astrum)
"GS" = (
/obj/effect/turf_decal/tile/neutral/fourcorners,
/obj/effect/turf_decal/bot,
/obj/structure/ore_box,
/obj/machinery/airalarm/directional/east,
/turf/open/floor/iron/dark/textured,
/area/shuttle/overmap/aev_p/astrum)
"GZ" = (
/obj/structure/lattice/catwalk,
/turf/open/space/basic,
/area/shuttle/overmap/aev_p/astrum)
"Hg" = (
/obj/machinery/atmospherics/pipe/smart/manifold4w/scrubbers/visible/layer2,
/turf/open/floor/mineral/plastitanium,
/area/shuttle/overmap/aev_p/astrum)
"Hm" = (
/obj/effect/spawner/structure/window/reinforced/plasma/plastitanium,
/obj/machinery/door/poddoor/shutters{
	id = "hermes shutter";
	name = "AEV Hermes Shutter"
	},
/turf/open/floor/plating,
/area/shuttle/overmap/aev_p/astrum)
"HC" = (
/obj/machinery/atmospherics/pipe/smart/manifold4w/orange/visible,
/obj/structure/table,
/obj/machinery/cell_charger,
/obj/item/stock_parts/cell/high,
/turf/open/floor/mineral/plastitanium,
/area/shuttle/overmap/aev_p/astrum)
"IR" = (
/obj/effect/turf_decal/stripes/line{
	dir = 10
	},
/obj/machinery/atmospherics/pipe/smart/manifold4w/scrubbers/visible/layer2,
/obj/machinery/atmospherics/pipe/smart/manifold4w/supply/visible/layer4,
/turf/open/floor/mineral/plastitanium,
/area/shuttle/overmap/aev_p/astrum)
"IW" = (
/obj/structure/marker_beacon/burgundy,
/obj/structure/lattice/catwalk,
/turf/open/space/basic,
/area/shuttle/overmap/aev_p/astrum)
"JZ" = (
/obj/machinery/power/apc/auto_name/directional/north,
/obj/effect/turf_decal/stripes/orange/corner{
	dir = 1
	},
/obj/machinery/atmospherics/pipe/smart/manifold4w/scrubbers/visible/layer2,
/obj/machinery/atmospherics/components/unary/vent_pump/on/layer4{
	dir = 8
	},
/turf/open/floor/mineral/plastitanium,
/area/shuttle/overmap/aev_p/astrum)
"KS" = (
/obj/structure/chair/comfy/shuttle{
	dir = 1
	},
/obj/effect/turf_decal/stripes/line{
	dir = 5
	},
/turf/open/floor/mineral/plastitanium,
/area/shuttle/overmap/aev_p/astrum)
"Lv" = (
/obj/effect/turf_decal/tile/neutral/fourcorners,
/obj/effect/turf_decal/bot,
/obj/structure/rack,
/obj/item/radio/intercom/directional/north,
/obj/item/storage/toolbox/mechanical,
/obj/item/storage/medkit/regular{
	pixel_y = 0
	},
/obj/item/crowbar/large,
/turf/open/floor/iron/dark/textured,
/area/shuttle/overmap/aev_p/astrum)
"LN" = (
/obj/effect/turf_decal/stripes/line{
	dir = 4
	},
/obj/machinery/holopad,
/turf/open/floor/mineral/plastitanium,
/area/shuttle/overmap/aev_p/astrum)
"MA" = (
/turf/open/floor/mineral/plastitanium,
/area/shuttle/overmap/aev_p/astrum)
"NF" = (
/obj/effect/turf_decal/tile/neutral/fourcorners,
/obj/effect/turf_decal/delivery,
/obj/structure/extinguisher_cabinet/directional/east,
/turf/open/floor/iron/dark/textured,
/area/shuttle/overmap/aev_p/astrum)
"PE" = (
/obj/effect/turf_decal/stripes/line,
/obj/effect/turf_decal/stripes/corner{
	dir = 4
	},
/obj/machinery/atmospherics/pipe/smart/manifold4w/scrubbers/visible/layer2,
/obj/machinery/atmospherics/pipe/smart/manifold4w/supply/visible/layer4,
/turf/open/floor/mineral/plastitanium,
/area/shuttle/overmap/aev_p/astrum)
"QE" = (
/obj/effect/turf_decal/stripes/line{
	dir = 5
	},
/turf/open/floor/mineral/plastitanium,
/area/shuttle/overmap/aev_p/astrum)
"SL" = (
/obj/effect/turf_decal/stripes/orange/line,
/obj/machinery/atmospherics/pipe/smart/manifold4w/orange/visible,
/obj/structure/closet/crate/internals,
/obj/item/tank/internals/emergency_oxygen,
/obj/item/tank/internals/emergency_oxygen,
/obj/item/clothing/mask/breath,
/obj/item/clothing/mask/breath,
/turf/open/floor/mineral/plastitanium,
/area/shuttle/overmap/aev_p/astrum)
"TG" = (
/obj/effect/turf_decal/stripes/end{
	dir = 4
	},
/obj/machinery/atmospherics/pipe/smart/manifold4w/scrubbers/visible/layer2,
/obj/machinery/atmospherics/pipe/smart/manifold4w/supply/visible/layer4,
/turf/open/floor/mineral/plastitanium,
/area/shuttle/overmap/aev_p/astrum)
"Uy" = (
/obj/effect/turf_decal/stripes/orange/box,
/obj/machinery/light_switch/directional/north,
/obj/machinery/light/small/directional/south,
/obj/machinery/atmospherics/components/binary/pump/off/scrubbers/visible/layer2{
	dir = 8
	},
/obj/machinery/atmospherics/components/binary/pump/off/supply/visible/layer4{
	dir = 4
	},
/turf/open/floor/mineral/plastitanium,
/area/shuttle/overmap/aev_p/astrum)
"VE" = (
/obj/effect/spawner/structure/window/reinforced/shuttle,
/obj/machinery/door/poddoor/shutters{
	id = "hermes shutter";
	name = "AEV Hermes Shutter";
	dir = 8
	},
/turf/open/floor/plating,
/area/shuttle/overmap/aev_p/astrum)
"Wj" = (
/obj/effect/turf_decal/stripes/line{
	dir = 8
	},
/obj/machinery/atmospherics/components/unary/vent_pump/on/layer4,
/turf/open/floor/mineral/plastitanium,
/area/shuttle/overmap/aev_p/astrum)
"Ws" = (
/turf/closed/wall/mineral/plastitanium,
/area/shuttle/overmap/aev_p/astrum)
"Xt" = (
/obj/machinery/light/directional/south,
/obj/effect/turf_decal/stripes/line,
/obj/machinery/atmospherics/pipe/smart/manifold4w/scrubbers/visible/layer2,
/obj/machinery/atmospherics/pipe/smart/manifold4w/supply/visible/layer4,
/turf/open/floor/mineral/plastitanium,
/area/shuttle/overmap/aev_p/astrum)
"Yk" = (
/obj/machinery/atmospherics/components/unary/engine,
/obj/effect/turf_decal/stripes/orange/line,
/turf/open/floor/plating,
/area/shuttle/overmap/aev_p/astrum)
"Zq" = (
/obj/machinery/firealarm/directional/west,
/obj/effect/turf_decal/stripes/line{
	dir = 8
	},
/obj/machinery/atmospherics/pipe/smart/manifold4w/supply/visible/layer4,
/turf/open/floor/mineral/plastitanium,
/area/shuttle/overmap/aev_p/astrum)

(1,1,1) = {"
nH
nH
nH
IW
BD
BD
nj
ey
nj
Ws
Ws
Ws
nH
"}
(2,1,1) = {"
vW
nj
VE
VE
VE
nj
nj
Uy
nj
uv
cn
Ws
Ws
"}
(3,1,1) = {"
GZ
kI
oj
oj
oj
oj
nj
Au
nj
bu
mg
Gs
Yk
"}
(4,1,1) = {"
GZ
kI
ph
Wj
kf
kf
Zq
IR
nj
Cb
cO
Gs
Yk
"}
(5,1,1) = {"
GZ
kI
QE
Af
vr
sl
Hg
Xt
nj
gO
Ai
Ws
Ws
"}
(6,1,1) = {"
mb
kI
cN
qL
NF
QE
LN
PE
ag
xx
HC
Hm
BD
"}
(7,1,1) = {"
vW
nj
nj
nj
nj
tn
GS
TG
nj
JZ
AG
Ws
Ws
"}
(8,1,1) = {"
nH
nH
IW
BD
nj
nj
nj
Bm
nj
CO
SL
Gs
Yk
"}
(9,1,1) = {"
nH
nH
nH
nH
rm
oF
ns
aF
nj
MA
BF
Gs
Yk
"}
(10,1,1) = {"
nH
nH
nH
nH
rm
eL
KS
jM
nj
oc
zh
Ws
Ws
"}
(11,1,1) = {"
nH
nH
nH
IW
nj
Lv
pu
cQ
nj
Ws
Ws
Ws
nH
"}
(12,1,1) = {"
nH
nH
nH
nH
nj
nj
VE
nj
nj
nH
nH
nH
nH
"}
